"","x01","x18l","x18r","x19","x36l","x36r","sum_dep","y01","y18l","y18r","y19","y36l","y36r","sum_arr","sum_per60","dep_prop_01","dep_prop_36l","dep_prop_36r","dep_prop_19","dep_prop_18r","dep_prop_18l","arr_prop_01","arr_prop_36l","arr_prop_36r","arr_prop_19","arr_prop_18r","arr_prop_18l"
"1",0,0,0,0,1,5,6,0,0,0,0,11,12,23,29,0,0.0344827586206897,0.172413793103448,0,0,0,0,0.379310344827586,0.413793103448276,0,0,0
"2",0,0,0,0,1,7,8,0,0,0,0,6,4,10,18,0,0.0555555555555556,0.388888888888889,0,0,0,0,0.333333333333333,0.222222222222222,0,0,0
"3",0,0,0,0,1,3,4,0,0,0,0,0,1,1,5,0,0.2,0.6,0,0,0,0,0,0.2,0,0,0
"4",0,0,0,0,0,0,0,0,0,0,0,0,1,1,1,0,0,0,0,0,0,0,0,1,0,0,0
"5",0,0,0,0,1,1,2,0,0,0,0,1,3,4,6,0,0.166666666666667,0.166666666666667,0,0,0,0,0.166666666666667,0.5,0,0,0
"6",0,0,0,0,0,0,0,0,0,0,0,0,8,8,8,0,0,0,0,0,0,0,0,1,0,0,0
"7",4,0,0,0,6,5,15,2,0,0,0,0,5,7,22,0.181818181818182,0.272727272727273,0.227272727272727,0,0,0,0.0909090909090909,0,0.227272727272727,0,0,0
"8",14,0,0,0,13,24,51,2,0,0,0,0,0,2,53,0.264150943396226,0.245283018867925,0.452830188679245,0,0,0,0.0377358490566038,0,0,0,0,0
"9",17,0,0,0,20,30,67,6,0,0,0,3,1,10,77,0.220779220779221,0.25974025974026,0.38961038961039,0,0,0,0.0779220779220779,0.038961038961039,0.012987012987013,0,0,0
"10",15,0,0,0,16,21,52,8,0,0,0,12,6,26,78,0.192307692307692,0.205128205128205,0.269230769230769,0,0,0,0.102564102564103,0.153846153846154,0.0769230769230769,0,0,0
"11",3,0,0,0,7,23,33,19,0,0,0,17,8,44,77,0.038961038961039,0.0909090909090909,0.298701298701299,0,0,0,0.246753246753247,0.220779220779221,0.103896103896104,0,0,0
"12",13,0,0,0,9,23,45,18,0,0,0,17,3,38,83,0.156626506024096,0.108433734939759,0.27710843373494,0,0,0,0.216867469879518,0.204819277108434,0.036144578313253,0,0,0
"13",8,0,0,0,9,21,38,17,0,0,0,12,8,37,75,0.106666666666667,0.12,0.28,0,0,0,0.226666666666667,0.16,0.106666666666667,0,0,0
"14",12,0,0,0,11,19,42,15,0,0,0,11,10,36,78,0.153846153846154,0.141025641025641,0.243589743589744,0,0,0,0.192307692307692,0.141025641025641,0.128205128205128,0,0,0
"15",18,0,0,0,9,18,45,16,0,0,0,14,12,42,87,0.206896551724138,0.103448275862069,0.206896551724138,0,0,0,0.183908045977011,0.160919540229885,0.137931034482759,0,0,0
"16",14,0,0,0,11,11,36,19,0,0,0,17,15,51,87,0.160919540229885,0.126436781609195,0.126436781609195,0,0,0,0.218390804597701,0.195402298850575,0.172413793103448,0,0,0
"17",13,0,0,0,7,25,45,17,0,0,0,18,8,43,88,0.147727272727273,0.0795454545454545,0.284090909090909,0,0,0,0.193181818181818,0.204545454545455,0.0909090909090909,0,0,0
"18",12,0,0,0,7,19,38,16,0,0,0,16,6,38,76,0.157894736842105,0.0921052631578947,0.25,0,0,0,0.210526315789474,0.210526315789474,0.0789473684210526,0,0,0
"19",6,0,0,0,3,18,27,24,0,0,0,18,2,44,71,0.0845070422535211,0.0422535211267606,0.253521126760563,0,0,0,0.338028169014085,0.253521126760563,0.028169014084507,0,0,0
"20",4,0,0,0,10,19,33,17,0,0,0,14,10,41,74,0.0540540540540541,0.135135135135135,0.256756756756757,0,0,0,0.22972972972973,0.189189189189189,0.135135135135135,0,0,0
"21",11,0,0,0,9,13,33,19,0,0,0,11,8,38,71,0.154929577464789,0.126760563380282,0.183098591549296,0,0,0,0.267605633802817,0.154929577464789,0.112676056338028,0,0,0
"22",1,0,0,0,8,17,26,15,0,0,0,11,8,34,60,0.0166666666666667,0.133333333333333,0.283333333333333,0,0,0,0.25,0.183333333333333,0.133333333333333,0,0,0
"23",2,0,0,0,3,6,11,20,0,0,0,14,8,42,53,0.0377358490566038,0.0566037735849057,0.113207547169811,0,0,0,0.377358490566038,0.264150943396226,0.150943396226415,0,0,0
"24",1,0,0,0,1,3,5,6,0,0,0,17,13,36,41,0.024390243902439,0.024390243902439,0.0731707317073171,0,0,0,0.146341463414634,0.414634146341463,0.317073170731707,0,0,0
"25",0,0,0,0,0,4,4,0,0,0,0,15,16,31,35,0,0,0.114285714285714,0,0,0,0,0.428571428571429,0.457142857142857,0,0,0
"26",0,0,0,0,0,8,8,0,0,0,0,5,4,9,17,0,0,0.470588235294118,0,0,0,0,0.294117647058824,0.235294117647059,0,0,0
"27",0,0,0,0,0,5,5,0,0,0,0,2,3,5,10,0,0,0.5,0,0,0,0,0.2,0.3,0,0,0
"28",0,0,0,0,0,1,1,0,0,0,0,0,0,0,1,0,0,1,0,0,0,0,0,0,0,0,0
"29",0,0,0,0,0,2,2,0,0,0,0,0,4,4,6,0,0,0.333333333333333,0,0,0,0,0,0.666666666666667,0,0,0
"30",0,0,0,0,0,0,0,0,0,0,0,0,5,5,5,0,0,0,0,0,0,0,0,1,0,0,0
"31",4,0,0,0,7,5,16,1,0,0,0,1,5,7,23,0.173913043478261,0.304347826086957,0.217391304347826,0,0,0,0.0434782608695652,0.0434782608695652,0.217391304347826,0,0,0
"32",12,0,0,0,14,28,54,1,0,0,0,0,2,3,57,0.210526315789474,0.245614035087719,0.491228070175439,0,0,0,0.0175438596491228,0,0.0350877192982456,0,0,0
"33",16,0,0,0,21,30,67,5,0,0,0,3,0,8,75,0.213333333333333,0.28,0.4,0,0,0,0.0666666666666667,0.04,0,0,0,0
"34",13,0,0,0,15,25,53,11,0,0,0,13,0,24,77,0.168831168831169,0.194805194805195,0.324675324675325,0,0,0,0.142857142857143,0.168831168831169,0,0,0,0
"35",8,0,0,0,5,21,34,19,0,0,0,16,8,43,77,0.103896103896104,0.0649350649350649,0.272727272727273,0,0,0,0.246753246753247,0.207792207792208,0.103896103896104,0,0,0
"36",13,0,0,0,10,24,47,16,0,0,0,16,6,38,85,0.152941176470588,0.117647058823529,0.282352941176471,0,0,0,0.188235294117647,0.188235294117647,0.0705882352941176,0,0,0
"37",8,0,0,0,6,25,39,20,0,0,0,16,4,40,79,0.10126582278481,0.0759493670886076,0.316455696202532,0,0,0,0.253164556962025,0.20253164556962,0.0506329113924051,0,0,0
"38",12,0,0,0,14,22,48,17,0,0,0,15,5,37,85,0.141176470588235,0.164705882352941,0.258823529411765,0,0,0,0.2,0.176470588235294,0.0588235294117647,0,0,0
"39",12,0,0,0,10,19,41,17,0,0,0,12,10,39,80,0.15,0.125,0.2375,0,0,0,0.2125,0.15,0.125,0,0,0
"40",10,0,0,0,11,17,38,21,0,0,0,13,12,46,84,0.119047619047619,0.130952380952381,0.202380952380952,0,0,0,0.25,0.154761904761905,0.142857142857143,0,0,0
"41",14,0,0,0,6,18,38,18,0,0,0,19,12,49,87,0.160919540229885,0.0689655172413793,0.206896551724138,0,0,0,0.206896551724138,0.218390804597701,0.137931034482759,0,0,0
"42",12,0,0,0,14,11,37,18,0,0,0,11,17,46,83,0.144578313253012,0.168674698795181,0.132530120481928,0,0,0,0.216867469879518,0.132530120481928,0.204819277108434,0,0,0
"43",10,0,0,0,10,17,37,19,0,0,0,16,13,48,85,0.117647058823529,0.117647058823529,0.2,0,0,0,0.223529411764706,0.188235294117647,0.152941176470588,0,0,0
"44",11,0,0,0,6,23,40,13,0,0,0,16,10,39,79,0.139240506329114,0.0759493670886076,0.291139240506329,0,0,0,0.164556962025316,0.20253164556962,0.126582278481013,0,0,0
"45",13,0,0,0,13,16,42,17,0,0,0,12,12,41,83,0.156626506024096,0.156626506024096,0.192771084337349,0,0,0,0.204819277108434,0.144578313253012,0.144578313253012,0,0,0
"46",3,0,0,0,8,20,31,12,0,0,0,14,10,36,67,0.0447761194029851,0.119402985074627,0.298507462686567,0,0,0,0.17910447761194,0.208955223880597,0.149253731343284,0,0,0
"47",7,0,0,0,4,5,16,16,0,0,0,14,16,46,62,0.112903225806452,0.0645161290322581,0.0806451612903226,0,0,0,0.258064516129032,0.225806451612903,0.258064516129032,0,0,0
"48",4,0,0,0,1,2,7,6,0,0,0,11,15,32,39,0.102564102564103,0.0256410256410256,0.0512820512820513,0,0,0,0.153846153846154,0.282051282051282,0.384615384615385,0,0,0
"49",0,0,0,0,1,4,5,0,0,0,0,21,19,40,45,0,0.0222222222222222,0.0888888888888889,0,0,0,0,0.466666666666667,0.422222222222222,0,0,0
"50",0,0,0,0,2,6,8,0,0,0,0,3,6,9,17,0,0.117647058823529,0.352941176470588,0,0,0,0,0.176470588235294,0.352941176470588,0,0,0
"51",0,0,0,0,1,1,2,0,0,0,0,4,2,6,8,0,0.125,0.125,0,0,0,0,0.5,0.25,0,0,0
"52",0,0,0,0,0,1,1,0,0,0,0,0,1,1,2,0,0,0.5,0,0,0,0,0,0.5,0,0,0
"53",0,0,0,0,0,1,1,0,0,0,0,2,5,7,8,0,0,0.125,0,0,0,0,0.25,0.625,0,0,0
"54",0,0,0,0,0,1,1,0,0,0,0,2,4,6,7,0,0,0.142857142857143,0,0,0,0,0.285714285714286,0.571428571428571,0,0,0
"55",4,0,0,0,7,11,22,1,0,0,0,1,6,8,30,0.133333333333333,0.233333333333333,0.366666666666667,0,0,0,0.0333333333333333,0.0333333333333333,0.2,0,0,0
"56",16,0,0,0,19,26,61,2,0,0,0,2,0,4,65,0.246153846153846,0.292307692307692,0.4,0,0,0,0.0307692307692308,0.0307692307692308,0,0,0,0
"57",19,0,0,0,23,30,72,8,0,0,0,4,0,12,84,0.226190476190476,0.273809523809524,0.357142857142857,0,0,0,0.0952380952380952,0.0476190476190476,0,0,0,0
"58",17,0,0,0,14,25,56,11,0,0,0,14,3,28,84,0.202380952380952,0.166666666666667,0.297619047619048,0,0,0,0.130952380952381,0.166666666666667,0.0357142857142857,0,0,0
"59",5,0,0,0,10,16,31,17,0,0,0,12,14,43,74,0.0675675675675676,0.135135135135135,0.216216216216216,0,0,0,0.22972972972973,0.162162162162162,0.189189189189189,0,0,0
"60",12,0,0,0,7,27,46,21,0,0,0,16,6,43,89,0.134831460674157,0.0786516853932584,0.303370786516854,0,0,0,0.235955056179775,0.179775280898876,0.0674157303370786,0,0,0
"61",16,0,0,0,9,20,45,16,0,0,0,15,9,40,85,0.188235294117647,0.105882352941176,0.235294117647059,0,0,0,0.188235294117647,0.176470588235294,0.105882352941176,0,0,0
"62",10,0,0,0,14,16,40,14,0,0,0,14,10,38,78,0.128205128205128,0.179487179487179,0.205128205128205,0,0,0,0.179487179487179,0.179487179487179,0.128205128205128,0,0,0
"63",13,0,0,0,4,27,44,21,0,0,0,15,5,41,85,0.152941176470588,0.0470588235294118,0.317647058823529,0,0,0,0.247058823529412,0.176470588235294,0.0588235294117647,0,0,0
"64",8,0,0,0,12,14,34,22,0,0,0,13,14,49,83,0.0963855421686747,0.144578313253012,0.168674698795181,0,0,0,0.265060240963855,0.156626506024096,0.168674698795181,0,0,0
"65",16,0,0,0,6,22,44,20,0,0,0,19,10,49,93,0.172043010752688,0.0645161290322581,0.236559139784946,0,0,0,0.21505376344086,0.204301075268817,0.10752688172043,0,0,0
"66",15,0,0,0,13,23,51,14,0,0,0,13,8,35,86,0.174418604651163,0.151162790697674,0.267441860465116,0,0,0,0.162790697674419,0.151162790697674,0.0930232558139535,0,0,0
"67",8,0,0,0,6,16,30,17,0,0,0,14,11,42,72,0.111111111111111,0.0833333333333333,0.222222222222222,0,0,0,0.236111111111111,0.194444444444444,0.152777777777778,0,0,0
"68",7,0,0,0,5,26,38,18,0,0,0,20,8,46,84,0.0833333333333333,0.0595238095238095,0.30952380952381,0,0,0,0.214285714285714,0.238095238095238,0.0952380952380952,0,0,0
"69",13,0,0,0,13,17,43,17,0,0,0,14,11,42,85,0.152941176470588,0.152941176470588,0.2,0,0,0,0.2,0.164705882352941,0.129411764705882,0,0,0
"70",2,0,0,0,10,20,32,19,0,0,0,15,9,43,75,0.0266666666666667,0.133333333333333,0.266666666666667,0,0,0,0.253333333333333,0.2,0.12,0,0,0
"71",4,0,0,0,10,11,25,20,0,0,0,18,17,55,80,0.05,0.125,0.1375,0,0,0,0.25,0.225,0.2125,0,0,0
"72",4,0,0,0,0,3,7,7,0,0,0,17,15,39,46,0.0869565217391304,0,0.0652173913043478,0,0,0,0.152173913043478,0.369565217391304,0.326086956521739,0,0,0
"73",3,0,0,0,1,1,5,0,0,0,0,22,23,45,50,0.06,0.02,0.02,0,0,0,0,0.44,0.46,0,0,0
"74",0,0,0,0,0,7,7,0,0,0,0,0,11,11,18,0,0,0.388888888888889,0,0,0,0,0,0.611111111111111,0,0,0
"75",0,0,0,0,0,3,3,0,0,0,0,0,1,1,4,0,0,0.75,0,0,0,0,0,0.25,0,0,0
"76",0,0,0,0,0,2,2,0,0,0,0,0,1,1,3,0,0,0.666666666666667,0,0,0,0,0,0.333333333333333,0,0,0
"77",0,0,0,0,0,1,1,0,0,0,0,0,4,4,5,0,0,0.2,0,0,0,0,0,0.8,0,0,0
"78",0,0,0,0,0,1,1,0,0,0,0,0,6,6,7,0,0,0.142857142857143,0,0,0,0,0,0.857142857142857,0,0,0
"79",3,0,0,0,7,8,18,0,0,0,0,0,5,5,23,0.130434782608696,0.304347826086957,0.347826086956522,0,0,0,0,0,0.217391304347826,0,0,0
"80",14,0,0,0,14,32,60,2,0,0,0,1,0,3,63,0.222222222222222,0.222222222222222,0.507936507936508,0,0,0,0.0317460317460317,0.0158730158730159,0,0,0,0
"81",17,0,0,0,21,32,70,5,0,0,0,2,1,8,78,0.217948717948718,0.269230769230769,0.41025641025641,0,0,0,0.0641025641025641,0.0256410256410256,0.0128205128205128,0,0,0
"82",14,0,0,0,17,25,56,14,0,0,0,14,4,32,88,0.159090909090909,0.193181818181818,0.284090909090909,0,0,0,0.159090909090909,0.159090909090909,0.0454545454545455,0,0,0
"83",5,0,0,0,7,15,27,19,0,0,0,16,14,49,76,0.0657894736842105,0.0921052631578947,0.197368421052632,0,0,0,0.25,0.210526315789474,0.184210526315789,0,0,0
"84",17,0,0,0,9,21,47,19,0,0,0,15,7,41,88,0.193181818181818,0.102272727272727,0.238636363636364,0,0,0,0.215909090909091,0.170454545454545,0.0795454545454545,0,0,0
"85",10,0,0,0,6,23,39,18,0,0,0,17,8,43,82,0.121951219512195,0.0731707317073171,0.280487804878049,0,0,0,0.219512195121951,0.207317073170732,0.0975609756097561,0,0,0
"86",8,0,0,0,14,21,43,20,0,0,0,13,5,38,81,0.0987654320987654,0.172839506172839,0.259259259259259,0,0,0,0.246913580246914,0.160493827160494,0.0617283950617284,0,0,0
"87",15,0,0,0,7,26,48,21,0,0,0,16,7,44,92,0.16304347826087,0.0760869565217391,0.282608695652174,0,0,0,0.228260869565217,0.173913043478261,0.0760869565217391,0,0,0
"88",9,0,0,0,14,16,39,19,0,0,0,14,10,43,82,0.109756097560976,0.170731707317073,0.195121951219512,0,0,0,0.231707317073171,0.170731707317073,0.121951219512195,0,0,0
"89",12,0,0,0,6,20,38,24,0,0,0,20,9,53,91,0.131868131868132,0.0659340659340659,0.21978021978022,0,0,0,0.263736263736264,0.21978021978022,0.0989010989010989,0,0,0
"90",17,0,0,0,13,25,55,17,0,0,0,14,5,36,91,0.186813186813187,0.142857142857143,0.274725274725275,0,0,0,0.186813186813187,0.153846153846154,0.0549450549450549,0,0,0
"91",8,0,0,0,7,23,38,21,0,0,0,20,8,49,87,0.0919540229885057,0.0804597701149425,0.264367816091954,0,0,0,0.241379310344828,0.229885057471264,0.0919540229885057,0,0,0
"92",11,0,0,0,8,23,42,15,0,0,0,17,8,40,82,0.134146341463415,0.0975609756097561,0.280487804878049,0,0,0,0.182926829268293,0.207317073170732,0.0975609756097561,0,0,0
"93",13,0,0,0,12,20,45,19,0,0,0,19,9,47,92,0.141304347826087,0.130434782608696,0.217391304347826,0,0,0,0.206521739130435,0.206521739130435,0.0978260869565217,0,0,0
"94",2,0,0,0,10,17,29,18,0,0,0,12,10,40,69,0.0289855072463768,0.144927536231884,0.246376811594203,0,0,0,0.260869565217391,0.173913043478261,0.144927536231884,0,0,0
"95",4,0,0,0,6,10,20,22,0,0,0,20,17,59,79,0.0506329113924051,0.0759493670886076,0.126582278481013,0,0,0,0.278481012658228,0.253164556962025,0.215189873417722,0,0,0
"96",9,0,0,0,3,3,15,11,0,0,0,17,20,48,63,0.142857142857143,0.0476190476190476,0.0476190476190476,0,0,0,0.174603174603175,0.26984126984127,0.317460317460317,0,0,0
"97",2,0,0,0,2,1,5,0,0,0,0,21,25,46,51,0.0392156862745098,0.0392156862745098,0.0196078431372549,0,0,0,0,0.411764705882353,0.490196078431373,0,0,0
"98",0,0,0,0,0,8,8,0,0,0,0,0,10,10,18,0,0,0.444444444444444,0,0,0,0,0,0.555555555555556,0,0,0
"99",0,0,0,0,0,6,6,0,0,0,0,0,3,3,9,0,0,0.666666666666667,0,0,0,0,0,0.333333333333333,0,0,0
"100",0,0,0,0,0,0,0,0,0,0,0,0,2,2,2,0,0,0,0,0,0,0,0,1,0,0,0
"101",0,0,0,0,0,2,2,0,0,0,0,0,3,3,5,0,0,0.4,0,0,0,0,0,0.6,0,0,0
"102",0,0,0,0,0,0,0,0,0,0,0,0,4,4,4,0,0,0,0,0,0,0,0,1,0,0,0
"103",6,0,0,0,8,8,22,0,0,0,0,0,8,8,30,0.2,0.266666666666667,0.266666666666667,0,0,0,0,0,0.266666666666667,0,0,0
"104",14,0,0,0,20,31,65,1,0,0,0,3,0,4,69,0.202898550724638,0.289855072463768,0.449275362318841,0,0,0,0.0144927536231884,0.0434782608695652,0,0,0,0
"105",16,0,0,0,26,31,73,7,0,0,0,3,0,10,83,0.192771084337349,0.313253012048193,0.373493975903614,0,0,0,0.0843373493975904,0.036144578313253,0,0,0,0
"106",20,0,0,0,14,24,58,11,0,0,0,14,4,29,87,0.229885057471264,0.160919540229885,0.275862068965517,0,0,0,0.126436781609195,0.160919540229885,0.0459770114942529,0,0,0
"107",5,0,0,0,10,12,27,19,0,0,0,22,14,55,82,0.0609756097560976,0.121951219512195,0.146341463414634,0,0,0,0.231707317073171,0.268292682926829,0.170731707317073,0,0,0
"108",16,0,0,0,8,28,52,17,0,0,0,19,5,41,93,0.172043010752688,0.0860215053763441,0.301075268817204,0,0,0,0.182795698924731,0.204301075268817,0.0537634408602151,0,0,0
"109",14,0,0,0,13,18,45,18,0,0,0,18,10,46,91,0.153846153846154,0.142857142857143,0.197802197802198,0,0,0,0.197802197802198,0.197802197802198,0.10989010989011,0,0,0
"110",14,0,0,0,12,17,43,16,0,0,0,12,12,40,83,0.168674698795181,0.144578313253012,0.204819277108434,0,0,0,0.192771084337349,0.144578313253012,0.144578313253012,0,0,0
"111",15,0,0,0,10,24,49,18,0,0,0,14,11,43,92,0.16304347826087,0.108695652173913,0.260869565217391,0,0,0,0.195652173913043,0.152173913043478,0.119565217391304,0,0,0
"112",13,0,0,0,9,11,33,17,0,0,0,19,17,53,86,0.151162790697674,0.104651162790698,0.127906976744186,0,0,0,0.197674418604651,0.22093023255814,0.197674418604651,0,0,0
"113",17,0,0,0,9,23,49,19,0,0,0,20,8,47,96,0.177083333333333,0.09375,0.239583333333333,0,0,0,0.197916666666667,0.208333333333333,0.0833333333333333,0,0,0
"114",17,0,0,0,13,23,53,18,0,0,0,13,9,40,93,0.182795698924731,0.139784946236559,0.247311827956989,0,0,0,0.193548387096774,0.139784946236559,0.0967741935483871,0,0,0
"115",11,0,0,0,12,18,41,19,0,0,0,19,11,49,90,0.122222222222222,0.133333333333333,0.2,0,0,0,0.211111111111111,0.211111111111111,0.122222222222222,0,0,0
"116",7,0,0,0,7,23,37,16,0,0,0,17,12,45,82,0.0853658536585366,0.0853658536585366,0.280487804878049,0,0,0,0.195121951219512,0.207317073170732,0.146341463414634,0,0,0
"117",14,0,0,0,12,23,49,18,0,0,0,15,9,42,91,0.153846153846154,0.131868131868132,0.252747252747253,0,0,0,0.197802197802198,0.164835164835165,0.0989010989010989,0,0,0
"118",6,0,0,0,9,15,30,19,0,0,0,18,11,48,78,0.0769230769230769,0.115384615384615,0.192307692307692,0,0,0,0.243589743589744,0.230769230769231,0.141025641025641,0,0,0
"119",6,0,0,0,8,14,28,19,0,0,0,19,13,51,79,0.0759493670886076,0.10126582278481,0.177215189873418,0,0,0,0.240506329113924,0.240506329113924,0.164556962025316,0,0,0
"120",1,0,0,0,3,4,8,9,0,0,0,17,20,46,54,0.0185185185185185,0.0555555555555556,0.0740740740740741,0,0,0,0.166666666666667,0.314814814814815,0.37037037037037,0,0,0
"121",0,0,0,0,0,3,3,0,0,0,0,23,26,49,52,0,0,0.0576923076923077,0,0,0,0,0.442307692307692,0.5,0,0,0
"122",0,0,0,0,3,9,12,0,0,0,0,4,10,14,26,0,0.115384615384615,0.346153846153846,0,0,0,0,0.153846153846154,0.384615384615385,0,0,0
"123",0,0,0,0,2,4,6,0,0,0,0,4,4,8,14,0,0.142857142857143,0.285714285714286,0,0,0,0,0.285714285714286,0.285714285714286,0,0,0
"124",0,0,0,0,1,0,1,0,0,0,0,1,3,4,5,0,0.2,0,0,0,0,0,0.2,0.6,0,0,0
"125",0,0,0,0,0,0,0,0,0,0,0,1,3,4,4,0,0,0,0,0,0,0,0.25,0.75,0,0,0
"126",0,0,0,0,0,1,1,0,0,0,0,2,6,8,9,0,0,0.111111111111111,0,0,0,0,0.222222222222222,0.666666666666667,0,0,0
"127",6,0,0,0,7,8,21,0,0,0,0,0,6,6,27,0.222222222222222,0.259259259259259,0.296296296296296,0,0,0,0,0,0.222222222222222,0,0,0
"128",11,0,0,0,19,32,62,2,0,0,0,2,0,4,66,0.166666666666667,0.287878787878788,0.484848484848485,0,0,0,0.0303030303030303,0.0303030303030303,0,0,0,0
"129",24,0,0,0,20,32,76,5,0,0,0,4,0,9,85,0.282352941176471,0.235294117647059,0.376470588235294,0,0,0,0.0588235294117647,0.0470588235294118,0,0,0,0
"130",16,0,0,0,16,21,53,16,0,0,0,11,5,32,85,0.188235294117647,0.188235294117647,0.247058823529412,0,0,0,0.188235294117647,0.129411764705882,0.0588235294117647,0,0,0
"131",9,0,0,0,8,11,28,18,0,0,0,18,17,53,81,0.111111111111111,0.0987654320987654,0.135802469135802,0,0,0,0.222222222222222,0.222222222222222,0.209876543209877,0,0,0
"132",12,0,0,0,8,22,42,23,0,0,0,17,9,49,91,0.131868131868132,0.0879120879120879,0.241758241758242,0,0,0,0.252747252747253,0.186813186813187,0.0989010989010989,0,0,0
"133",14,0,0,0,11,32,57,20,0,0,0,16,5,41,98,0.142857142857143,0.112244897959184,0.326530612244898,0,0,0,0.204081632653061,0.163265306122449,0.0510204081632653,0,0,0
"134",12,0,0,0,12,21,45,19,0,0,0,12,9,40,85,0.141176470588235,0.141176470588235,0.247058823529412,0,0,0,0.223529411764706,0.141176470588235,0.105882352941176,0,0,0
"135",16,0,0,0,8,20,44,19,0,0,0,14,11,44,88,0.181818181818182,0.0909090909090909,0.227272727272727,0,0,0,0.215909090909091,0.159090909090909,0.125,0,0,0
"136",12,0,0,0,13,18,43,18,0,0,0,12,10,40,83,0.144578313253012,0.156626506024096,0.216867469879518,0,0,0,0.216867469879518,0.144578313253012,0.120481927710843,0,0,0
"137",16,0,0,0,5,23,44,20,0,0,0,18,9,47,91,0.175824175824176,0.0549450549450549,0.252747252747253,0,0,0,0.21978021978022,0.197802197802198,0.0989010989010989,0,0,0
"138",15,0,0,0,11,19,45,16,0,0,0,17,14,47,92,0.16304347826087,0.119565217391304,0.206521739130435,0,0,0,0.173913043478261,0.184782608695652,0.152173913043478,0,0,0
"139",12,0,0,0,10,16,38,20,0,0,0,19,14,53,91,0.131868131868132,0.10989010989011,0.175824175824176,0,0,0,0.21978021978022,0.208791208791209,0.153846153846154,0,0,0
"140",10,0,0,0,10,24,44,17,0,0,0,18,9,44,88,0.113636363636364,0.113636363636364,0.272727272727273,0,0,0,0.193181818181818,0.204545454545455,0.102272727272727,0,0,0
"141",15,0,0,0,17,24,56,17,0,0,0,16,7,40,96,0.15625,0.177083333333333,0.25,0,0,0,0.177083333333333,0.166666666666667,0.0729166666666667,0,0,0
"142",5,0,0,0,8,15,28,17,0,0,0,18,11,46,74,0.0675675675675676,0.108108108108108,0.202702702702703,0,0,0,0.22972972972973,0.243243243243243,0.148648648648649,0,0,0
"143",14,0,0,0,7,4,25,18,0,0,0,15,16,49,74,0.189189189189189,0.0945945945945946,0.0540540540540541,0,0,0,0.243243243243243,0.202702702702703,0.216216216216216,0,0,0
"144",10,0,0,0,4,0,14,7,0,0,0,17,21,45,59,0.169491525423729,0.0677966101694915,0,0,0,0,0.11864406779661,0.288135593220339,0.355932203389831,0,0,0
"145",5,2,0,0,1,0,8,0,0,0,0,28,27,55,63,0.0793650793650794,0.0158730158730159,0,0,0,0.0317460317460317,0,0.444444444444444,0.428571428571429,0,0,0
"146",1,0,0,0,3,5,9,0,0,0,0,9,13,22,31,0.032258064516129,0.0967741935483871,0.161290322580645,0,0,0,0,0.290322580645161,0.419354838709677,0,0,0
"147",0,0,0,0,1,5,6,0,0,0,0,4,6,10,16,0,0.0625,0.3125,0,0,0,0,0.25,0.375,0,0,0
"148",0,0,0,0,0,2,2,0,0,0,0,0,1,1,3,0,0,0.666666666666667,0,0,0,0,0,0.333333333333333,0,0,0
"149",0,0,0,0,0,1,1,0,0,0,0,1,5,6,7,0,0,0.142857142857143,0,0,0,0,0.142857142857143,0.714285714285714,0,0,0
"150",0,0,0,0,0,3,3,0,0,0,0,0,7,7,10,0,0,0.3,0,0,0,0,0,0.7,0,0,0
"151",6,0,0,0,5,6,17,0,0,0,0,1,7,8,25,0.24,0.2,0.24,0,0,0,0,0.04,0.28,0,0,0
"152",9,0,0,0,11,24,44,1,0,0,0,3,2,6,50,0.18,0.22,0.48,0,0,0,0.02,0.06,0.04,0,0,0
"153",8,0,0,0,13,25,46,5,0,0,0,3,1,9,55,0.145454545454545,0.236363636363636,0.454545454545455,0,0,0,0.0909090909090909,0.0545454545454545,0.0181818181818182,0,0,0
"154",8,0,0,0,11,23,42,8,0,0,0,15,9,32,74,0.108108108108108,0.148648648648649,0.310810810810811,0,0,0,0.108108108108108,0.202702702702703,0.121621621621622,0,0,0
"155",6,0,0,0,9,23,38,12,0,0,0,17,8,37,75,0.08,0.12,0.306666666666667,0,0,0,0.16,0.226666666666667,0.106666666666667,0,0,0
"156",8,0,0,0,7,26,41,21,0,0,0,19,2,42,83,0.0963855421686747,0.0843373493975904,0.313253012048193,0,0,0,0.253012048192771,0.228915662650602,0.0240963855421687,0,0,0
"157",10,0,0,0,17,5,32,21,0,0,0,16,4,41,73,0.136986301369863,0.232876712328767,0.0684931506849315,0,0,0,0.287671232876712,0.219178082191781,0.0547945205479452,0,0,0
"158",12,0,0,0,10,24,46,19,0,0,0,6,11,36,82,0.146341463414634,0.121951219512195,0.292682926829268,0,0,0,0.231707317073171,0.0731707317073171,0.134146341463415,0,0,0
"159",17,0,0,0,13,28,58,18,0,0,0,12,4,34,92,0.184782608695652,0.141304347826087,0.304347826086957,0,0,0,0.195652173913043,0.130434782608696,0.0434782608695652,0,0,0
"160",18,0,0,0,8,34,60,18,0,0,0,25,0,43,103,0.174757281553398,0.0776699029126214,0.330097087378641,0,0,0,0.174757281553398,0.242718446601942,0,0,0,0
"161",13,0,0,0,9,24,46,20,0,0,0,19,7,46,92,0.141304347826087,0.0978260869565217,0.260869565217391,0,0,0,0.217391304347826,0.206521739130435,0.0760869565217391,0,0,0
"162",14,0,0,0,12,26,52,19,0,0,0,17,5,41,93,0.150537634408602,0.129032258064516,0.279569892473118,0,0,0,0.204301075268817,0.182795698924731,0.0537634408602151,0,0,0
"163",11,0,0,0,13,16,40,18,0,0,0,16,15,49,89,0.123595505617978,0.146067415730337,0.179775280898876,0,0,0,0.202247191011236,0.179775280898876,0.168539325842697,0,0,0
"164",13,0,0,0,11,25,49,19,0,0,0,20,8,47,96,0.135416666666667,0.114583333333333,0.260416666666667,0,0,0,0.197916666666667,0.208333333333333,0.0833333333333333,0,0,0
"165",10,0,0,0,10,21,41,16,0,0,0,11,8,35,76,0.131578947368421,0.131578947368421,0.276315789473684,0,0,0,0.210526315789474,0.144736842105263,0.105263157894737,0,0,0
"166",8,0,0,0,4,20,32,18,0,0,0,16,9,43,75,0.106666666666667,0.0533333333333333,0.266666666666667,0,0,0,0.24,0.213333333333333,0.12,0,0,0
"167",2,0,0,0,8,11,21,11,0,0,0,22,19,52,73,0.0273972602739726,0.10958904109589,0.150684931506849,0,0,0,0.150684931506849,0.301369863013699,0.26027397260274,0,0,0
"168",0,2,0,0,1,0,3,12,0,5,4,11,0,32,35,0,0.0285714285714286,0,0,0,0.0571428571428571,0.342857142857143,0.314285714285714,0,0.114285714285714,0.142857142857143,0
"169",0,11,1,0,0,0,12,0,18,8,25,0,0,51,63,0,0,0,0,0.0158730158730159,0.174603174603175,0,0,0,0.396825396825397,0.126984126984127,0.285714285714286
"170",0,23,0,0,0,0,23,0,1,22,18,0,0,41,64,0,0,0,0,0,0.359375,0,0,0,0.28125,0.34375,0.015625
"171",0,13,0,0,0,2,15,0,0,13,6,0,1,20,35,0,0,0.0571428571428571,0,0,0.371428571428571,0,0,0.0285714285714286,0.171428571428571,0.371428571428571,0
"172",0,0,0,0,2,6,8,0,0,0,0,3,4,7,15,0,0.133333333333333,0.4,0,0,0,0,0.2,0.266666666666667,0,0,0
"173",0,0,0,0,0,1,1,0,0,0,0,0,7,7,8,0,0,0.125,0,0,0,0,0,0.875,0,0,0
"174",0,0,0,0,1,1,2,0,0,0,0,6,0,6,8,0,0.125,0.125,0,0,0,0,0.75,0,0,0,0
"175",0,0,0,0,2,1,3,0,0,0,0,2,6,8,11,0,0.181818181818182,0.0909090909090909,0,0,0,0,0.181818181818182,0.545454545454545,0,0,0
"176",9,0,0,0,10,17,36,1,0,0,0,2,1,4,40,0.225,0.25,0.425,0,0,0,0.025,0.05,0.025,0,0,0
"177",16,0,0,0,8,29,53,7,0,0,0,5,1,13,66,0.242424242424242,0.121212121212121,0.439393939393939,0,0,0,0.106060606060606,0.0757575757575758,0.0151515151515152,0,0,0
"178",16,0,0,0,13,28,57,12,0,0,0,13,2,27,84,0.19047619047619,0.154761904761905,0.333333333333333,0,0,0,0.142857142857143,0.154761904761905,0.0238095238095238,0,0,0
"179",11,0,0,0,12,27,50,24,0,0,0,20,6,50,100,0.11,0.12,0.27,0,0,0,0.24,0.2,0.06,0,0,0
"180",16,0,0,0,18,35,69,19,0,0,0,18,1,38,107,0.149532710280374,0.168224299065421,0.327102803738318,0,0,0,0.177570093457944,0.168224299065421,0.00934579439252336,0,0,0
"181",15,0,0,0,13,26,54,18,0,0,0,13,6,37,91,0.164835164835165,0.142857142857143,0.285714285714286,0,0,0,0.197802197802198,0.142857142857143,0.0659340659340659,0,0,0
"182",15,0,0,0,12,23,50,18,0,0,0,14,8,40,90,0.166666666666667,0.133333333333333,0.255555555555556,0,0,0,0.2,0.155555555555556,0.0888888888888889,0,0,0
"183",15,0,0,0,10,21,46,14,0,0,0,15,9,38,84,0.178571428571429,0.119047619047619,0.25,0,0,0,0.166666666666667,0.178571428571429,0.107142857142857,0,0,0
"184",9,0,0,0,10,13,32,21,0,0,0,15,16,52,84,0.107142857142857,0.119047619047619,0.154761904761905,0,0,0,0.25,0.178571428571429,0.19047619047619,0,0,0
"185",11,0,0,0,14,21,46,21,0,0,0,18,10,49,95,0.115789473684211,0.147368421052632,0.221052631578947,0,0,0,0.221052631578947,0.189473684210526,0.105263157894737,0,0,0
"186",12,0,0,0,9,18,39,19,0,0,0,20,10,49,88,0.136363636363636,0.102272727272727,0.204545454545455,0,0,0,0.215909090909091,0.227272727272727,0.113636363636364,0,0,0
"187",11,0,0,0,9,28,48,22,0,0,0,23,4,49,97,0.11340206185567,0.0927835051546392,0.288659793814433,0,0,0,0.22680412371134,0.237113402061856,0.0412371134020619,0,0,0
"188",11,0,0,0,9,21,41,22,0,0,0,24,9,55,96,0.114583333333333,0.09375,0.21875,0,0,0,0.229166666666667,0.25,0.09375,0,0,0
"189",14,0,0,0,9,29,52,19,0,0,0,21,1,41,93,0.150537634408602,0.0967741935483871,0.311827956989247,0,0,0,0.204301075268817,0.225806451612903,0.010752688172043,0,0,0
"190",10,0,0,0,20,25,55,19,0,0,0,11,7,37,92,0.108695652173913,0.217391304347826,0.271739130434783,0,0,0,0.206521739130435,0.119565217391304,0.0760869565217391,0,0,0
"191",5,0,0,0,8,13,26,21,0,0,0,23,11,55,81,0.0617283950617284,0.0987654320987654,0.160493827160494,0,0,0,0.259259259259259,0.283950617283951,0.135802469135802,0,0,0
"192",5,2,0,0,3,3,13,11,0,0,0,12,16,39,52,0.0961538461538462,0.0576923076923077,0.0576923076923077,0,0,0.0384615384615385,0.211538461538462,0.230769230769231,0.307692307692308,0,0,0
"193",4,0,0,0,2,0,6,0,0,0,0,26,28,54,60,0.0666666666666667,0.0333333333333333,0,0,0,0,0,0.433333333333333,0.466666666666667,0,0,0
"194",0,0,0,0,5,4,9,0,0,0,0,18,18,36,45,0,0.111111111111111,0.0888888888888889,0,0,0,0,0.4,0.4,0,0,0
"195",0,0,0,0,15,0,15,0,0,0,0,7,0,7,22,0,0.681818181818182,0,0,0,0,0,0.318181818181818,0,0,0,0
"196",0,0,0,0,2,0,2,0,0,0,0,4,0,4,6,0,0.333333333333333,0,0,0,0,0,0.666666666666667,0,0,0,0
"197",0,0,0,0,0,0,0,0,0,0,0,3,0,3,3,0,0,0,0,0,0,0,1,0,0,0,0
"198",0,0,0,0,1,0,1,0,0,0,0,8,0,8,9,0,0.111111111111111,0,0,0,0,0,0.888888888888889,0,0,0,0
"199",4,0,0,0,9,9,22,1,0,0,0,6,2,9,31,0.129032258064516,0.290322580645161,0.290322580645161,0,0,0,0.032258064516129,0.193548387096774,0.0645161290322581,0,0,0
"200",15,0,0,0,15,30,60,0,0,0,0,5,1,6,66,0.227272727272727,0.227272727272727,0.454545454545455,0,0,0,0,0.0757575757575758,0.0151515151515152,0,0,0
"201",19,0,0,0,25,27,71,6,0,0,0,5,0,11,82,0.231707317073171,0.304878048780488,0.329268292682927,0,0,0,0.0731707317073171,0.0609756097560976,0,0,0,0
"202",14,0,0,0,18,24,56,13,0,0,0,12,7,32,88,0.159090909090909,0.204545454545455,0.272727272727273,0,0,0,0.147727272727273,0.136363636363636,0.0795454545454545,0,0,0
"203",4,0,0,0,9,14,27,17,0,0,0,12,13,42,69,0.0579710144927536,0.130434782608696,0.202898550724638,0,0,0,0.246376811594203,0.173913043478261,0.188405797101449,0,0,0
"204",17,0,0,0,7,15,39,18,0,0,0,12,13,43,82,0.207317073170732,0.0853658536585366,0.182926829268293,0,0,0,0.219512195121951,0.146341463414634,0.158536585365854,0,0,0
"205",13,0,0,0,8,26,47,16,0,0,0,16,7,39,86,0.151162790697674,0.0930232558139535,0.302325581395349,0,0,0,0.186046511627907,0.186046511627907,0.0813953488372093,0,0,0
"206",16,0,0,0,18,14,48,14,0,0,0,16,14,44,92,0.173913043478261,0.195652173913043,0.152173913043478,0,0,0,0.152173913043478,0.173913043478261,0.152173913043478,0,0,0
"207",18,0,0,0,9,22,49,18,0,0,0,14,8,40,89,0.202247191011236,0.101123595505618,0.247191011235955,0,0,0,0.202247191011236,0.157303370786517,0.0898876404494382,0,0,0
"208",13,0,0,0,11,15,39,19,0,0,0,17,15,51,90,0.144444444444444,0.122222222222222,0.166666666666667,0,0,0,0.211111111111111,0.188888888888889,0.166666666666667,0,0,0
"209",19,0,0,0,11,17,47,19,0,0,0,18,15,52,99,0.191919191919192,0.111111111111111,0.171717171717172,0,0,0,0.191919191919192,0.181818181818182,0.151515151515152,0,0,0
"210",18,0,0,0,11,18,47,17,0,0,0,15,13,45,92,0.195652173913043,0.119565217391304,0.195652173913043,0,0,0,0.184782608695652,0.16304347826087,0.141304347826087,0,0,0
"211",9,0,0,0,8,19,36,23,0,0,0,19,13,55,91,0.0989010989010989,0.0879120879120879,0.208791208791209,0,0,0,0.252747252747253,0.208791208791209,0.142857142857143,0,0,0
"212",10,0,0,0,9,21,40,22,0,0,0,19,12,53,93,0.10752688172043,0.0967741935483871,0.225806451612903,0,0,0,0.236559139784946,0.204301075268817,0.129032258064516,0,0,0
"213",15,0,0,0,11,29,55,18,0,0,0,17,5,40,95,0.157894736842105,0.115789473684211,0.305263157894737,0,0,0,0.189473684210526,0.178947368421053,0.0526315789473684,0,0,0
"214",5,0,0,0,14,20,39,17,0,0,0,14,8,39,78,0.0641025641025641,0.179487179487179,0.256410256410256,0,0,0,0.217948717948718,0.179487179487179,0.102564102564103,0,0,0
"215",6,0,0,0,10,12,28,22,0,0,0,19,15,56,84,0.0714285714285714,0.119047619047619,0.142857142857143,0,0,0,0.261904761904762,0.226190476190476,0.178571428571429,0,0,0
"216",6,0,0,0,1,3,10,9,0,0,0,17,22,48,58,0.103448275862069,0.0172413793103448,0.0517241379310345,0,0,0,0.155172413793103,0.293103448275862,0.379310344827586,0,0,0
"217",2,0,0,0,3,4,9,0,0,0,0,24,23,47,56,0.0357142857142857,0.0535714285714286,0.0714285714285714,0,0,0,0,0.428571428571429,0.410714285714286,0,0,0
"218",0,0,0,0,1,6,7,0,0,0,0,8,8,16,23,0,0.0434782608695652,0.260869565217391,0,0,0,0,0.347826086956522,0.347826086956522,0,0,0
"219",0,0,0,0,0,8,8,0,0,0,0,3,8,11,19,0,0,0.421052631578947,0,0,0,0,0.157894736842105,0.421052631578947,0,0,0
"220",0,0,0,0,1,1,2,0,0,0,0,2,6,8,10,0,0.1,0.1,0,0,0,0,0.2,0.6,0,0,0
"221",0,4,0,0,0,0,4,0,4,0,0,0,0,4,8,0,0,0,0,0,0.5,0,0,0,0,0,0.5
"222",0,0,0,0,0,2,2,0,6,1,0,0,3,10,12,0,0,0.166666666666667,0,0,0,0,0,0.25,0,0.0833333333333333,0.5
"223",6,0,0,0,8,13,27,1,0,0,0,1,7,9,36,0.166666666666667,0.222222222222222,0.361111111111111,0,0,0,0.0277777777777778,0.0277777777777778,0.194444444444444,0,0,0
"224",16,0,0,0,14,32,62,4,0,0,0,2,0,6,68,0.235294117647059,0.205882352941176,0.470588235294118,0,0,0,0.0588235294117647,0.0294117647058824,0,0,0,0
"225",18,0,0,0,26,30,74,8,0,0,0,5,0,13,87,0.206896551724138,0.298850574712644,0.344827586206897,0,0,0,0.0919540229885057,0.0574712643678161,0,0,0,0
"226",13,0,0,0,13,25,51,14,0,0,0,12,4,30,81,0.160493827160494,0.160493827160494,0.308641975308642,0,0,0,0.172839506172839,0.148148148148148,0.0493827160493827,0,0,0
"227",11,0,0,0,9,15,35,19,0,0,0,16,14,49,84,0.130952380952381,0.107142857142857,0.178571428571429,0,0,0,0.226190476190476,0.19047619047619,0.166666666666667,0,0,0
"228",11,0,0,0,8,13,32,22,0,0,0,19,17,58,90,0.122222222222222,0.0888888888888889,0.144444444444444,0,0,0,0.244444444444444,0.211111111111111,0.188888888888889,0,0,0
"229",18,0,0,0,9,27,54,18,0,0,0,18,6,42,96,0.1875,0.09375,0.28125,0,0,0,0.1875,0.1875,0.0625,0,0,0
"230",16,0,0,0,16,24,56,17,0,0,0,13,9,39,95,0.168421052631579,0.168421052631579,0.252631578947368,0,0,0,0.178947368421053,0.136842105263158,0.0947368421052632,0,0,0
"231",16,0,0,0,10,23,49,19,0,0,0,15,7,41,90,0.177777777777778,0.111111111111111,0.255555555555556,0,0,0,0.211111111111111,0.166666666666667,0.0777777777777778,0,0,0
"232",7,0,0,0,11,16,34,17,0,0,0,14,14,45,79,0.0886075949367089,0.139240506329114,0.20253164556962,0,0,0,0.215189873417722,0.177215189873418,0.177215189873418,0,0,0
"233",17,0,0,0,10,19,46,21,0,0,0,19,12,52,98,0.173469387755102,0.102040816326531,0.193877551020408,0,0,0,0.214285714285714,0.193877551020408,0.122448979591837,0,0,0
"234",18,0,0,0,12,20,50,18,0,0,0,17,10,45,95,0.189473684210526,0.126315789473684,0.210526315789474,0,0,0,0.189473684210526,0.178947368421053,0.105263157894737,0,0,0
"235",15,0,0,0,9,14,38,17,0,0,0,15,17,49,87,0.172413793103448,0.103448275862069,0.160919540229885,0,0,0,0.195402298850575,0.172413793103448,0.195402298850575,0,0,0
"236",15,0,0,0,7,28,50,15,0,0,0,17,7,39,89,0.168539325842697,0.0786516853932584,0.314606741573034,0,0,0,0.168539325842697,0.191011235955056,0.0786516853932584,0,0,0
"237",14,0,0,0,13,19,46,16,0,0,0,15,11,42,88,0.159090909090909,0.147727272727273,0.215909090909091,0,0,0,0.181818181818182,0.170454545454545,0.125,0,0,0
"238",6,0,0,0,11,16,33,14,0,0,0,12,13,39,72,0.0833333333333333,0.152777777777778,0.222222222222222,0,0,0,0.194444444444444,0.166666666666667,0.180555555555556,0,0,0
"239",8,0,0,0,9,6,23,19,0,0,0,21,21,61,84,0.0952380952380952,0.107142857142857,0.0714285714285714,0,0,0,0.226190476190476,0.25,0.25,0,0,0
"240",10,0,0,0,1,0,11,9,0,0,0,17,22,48,59,0.169491525423729,0.0169491525423729,0,0,0,0,0.152542372881356,0.288135593220339,0.372881355932203,0,0,0
"241",5,0,0,0,1,1,7,0,0,0,0,23,23,46,53,0.0943396226415094,0.0188679245283019,0.0188679245283019,0,0,0,0,0.433962264150943,0.433962264150943,0,0,0
"242",0,0,0,0,0,9,9,0,0,0,0,10,10,20,29,0,0,0.310344827586207,0,0,0,0,0.344827586206897,0.344827586206897,0,0,0
"243",0,0,0,0,1,7,8,0,0,0,0,0,2,2,10,0,0.1,0.7,0,0,0,0,0,0.2,0,0,0
"244",0,1,0,0,0,2,3,0,0,0,0,0,2,2,5,0,0,0.4,0,0,0.2,0,0,0.4,0,0,0
"245",0,1,0,0,0,0,1,0,8,0,0,0,0,8,9,0,0,0,0,0,0.111111111111111,0,0,0,0,0,0.888888888888889
"246",0,2,0,0,0,0,2,0,7,0,0,0,0,7,9,0,0,0,0,0,0.222222222222222,0,0,0,0,0,0.777777777777778
"247",5,0,0,0,4,13,22,1,1,0,0,0,11,13,35,0.142857142857143,0.114285714285714,0.371428571428571,0,0,0,0.0285714285714286,0,0.314285714285714,0,0,0.0285714285714286
"248",13,0,0,0,19,26,58,3,0,0,0,4,0,7,65,0.2,0.292307692307692,0.4,0,0,0,0.0461538461538462,0.0615384615384615,0,0,0,0
"249",18,0,0,0,27,26,71,7,0,0,0,3,2,12,83,0.216867469879518,0.325301204819277,0.313253012048193,0,0,0,0.0843373493975904,0.036144578313253,0.0240963855421687,0,0,0
"250",17,0,0,0,21,22,60,10,0,0,0,11,9,30,90,0.188888888888889,0.233333333333333,0.244444444444444,0,0,0,0.111111111111111,0.122222222222222,0.1,0,0,0
"251",7,0,0,0,8,15,30,21,0,0,0,18,14,53,83,0.0843373493975904,0.0963855421686747,0.180722891566265,0,0,0,0.253012048192771,0.216867469879518,0.168674698795181,0,0,0
"252",12,0,0,0,7,26,45,20,0,0,0,21,4,45,90,0.133333333333333,0.0777777777777778,0.288888888888889,0,0,0,0.222222222222222,0.233333333333333,0.0444444444444444,0,0,0
"253",11,0,0,0,10,19,40,16,0,0,0,19,9,44,84,0.130952380952381,0.119047619047619,0.226190476190476,0,0,0,0.19047619047619,0.226190476190476,0.107142857142857,0,0,0
"254",13,0,0,0,14,19,46,14,0,0,0,13,11,38,84,0.154761904761905,0.166666666666667,0.226190476190476,0,0,0,0.166666666666667,0.154761904761905,0.130952380952381,0,0,0
"255",13,0,0,0,9,23,45,17,0,0,0,17,10,44,89,0.146067415730337,0.101123595505618,0.258426966292135,0,0,0,0.191011235955056,0.191011235955056,0.112359550561798,0,0,0
"256",11,0,0,0,8,23,42,16,0,0,0,20,9,45,87,0.126436781609195,0.0919540229885057,0.264367816091954,0,0,0,0.183908045977011,0.229885057471264,0.103448275862069,0,0,0
"257",14,0,0,0,11,17,42,20,0,0,0,21,13,54,96,0.145833333333333,0.114583333333333,0.177083333333333,0,0,0,0.208333333333333,0.21875,0.135416666666667,0,0,0
"258",20,0,0,0,11,24,55,16,0,0,0,18,9,43,98,0.204081632653061,0.112244897959184,0.244897959183673,0,0,0,0.163265306122449,0.183673469387755,0.0918367346938776,0,0,0
"259",12,0,0,0,9,23,44,19,0,0,0,16,9,44,88,0.136363636363636,0.102272727272727,0.261363636363636,0,0,0,0.215909090909091,0.181818181818182,0.102272727272727,0,0,0
"260",10,0,0,0,9,23,42,19,0,0,0,16,8,43,85,0.117647058823529,0.105882352941176,0.270588235294118,0,0,0,0.223529411764706,0.188235294117647,0.0941176470588235,0,0,0
"261",14,0,0,0,14,23,51,14,0,0,0,16,10,40,91,0.153846153846154,0.153846153846154,0.252747252747253,0,0,0,0.153846153846154,0.175824175824176,0.10989010989011,0,0,0
"262",1,0,0,0,10,16,27,19,0,0,0,15,11,45,72,0.0138888888888889,0.138888888888889,0.222222222222222,0,0,0,0.263888888888889,0.208333333333333,0.152777777777778,0,0,0
"263",5,0,0,0,8,10,23,19,0,0,0,19,18,56,79,0.0632911392405063,0.10126582278481,0.126582278481013,0,0,0,0.240506329113924,0.240506329113924,0.227848101265823,0,0,0
"264",6,0,0,0,1,4,11,11,0,0,0,19,18,48,59,0.101694915254237,0.0169491525423729,0.0677966101694915,0,0,0,0.186440677966102,0.322033898305085,0.305084745762712,0,0,0
"265",10,0,0,0,2,0,12,0,0,0,0,25,27,52,64,0.15625,0.03125,0,0,0,0,0,0.390625,0.421875,0,0,0
"266",0,0,0,0,3,5,8,0,0,0,0,3,8,11,19,0,0.157894736842105,0.263157894736842,0,0,0,0,0.157894736842105,0.421052631578947,0,0,0
"267",0,0,0,0,1,4,5,0,0,0,0,4,1,5,10,0,0.1,0.4,0,0,0,0,0.4,0.1,0,0,0
"268",0,0,0,0,0,2,2,0,0,0,0,0,1,1,3,0,0,0.666666666666667,0,0,0,0,0,0.333333333333333,0,0,0
"269",0,4,0,0,0,0,4,0,9,0,0,0,0,9,13,0,0,0,0,0,0.307692307692308,0,0,0,0,0,0.692307692307692
"270",0,3,0,0,0,0,3,0,4,0,0,0,0,4,7,0,0,0,0,0,0.428571428571429,0,0,0,0,0,0.571428571428571
"271",6,0,0,0,6,10,22,1,8,0,0,2,0,11,33,0.181818181818182,0.181818181818182,0.303030303030303,0,0,0,0.0303030303030303,0.0606060606060606,0,0,0,0.242424242424242
"272",17,0,0,0,16,31,64,2,0,0,0,3,0,5,69,0.246376811594203,0.231884057971014,0.449275362318841,0,0,0,0.0289855072463768,0.0434782608695652,0,0,0,0
"273",19,0,0,0,21,35,75,8,0,0,0,6,0,14,89,0.213483146067416,0.235955056179775,0.393258426966292,0,0,0,0.0898876404494382,0.0674157303370786,0,0,0,0
"274",16,0,0,0,18,24,58,13,0,0,0,14,6,33,91,0.175824175824176,0.197802197802198,0.263736263736264,0,0,0,0.142857142857143,0.153846153846154,0.0659340659340659,0,0,0
"275",5,0,0,0,8,19,32,20,0,0,0,16,12,48,80,0.0625,0.1,0.2375,0,0,0,0.25,0.2,0.15,0,0,0
"276",16,0,0,0,7,21,44,18,0,0,0,16,11,45,89,0.179775280898876,0.0786516853932584,0.235955056179775,0,0,0,0.202247191011236,0.179775280898876,0.123595505617978,0,0,0
"277",13,0,0,0,12,21,46,17,0,0,0,14,9,40,86,0.151162790697674,0.13953488372093,0.244186046511628,0,0,0,0.197674418604651,0.162790697674419,0.104651162790698,0,0,0
"278",13,0,0,0,12,22,47,19,0,0,0,15,7,41,88,0.147727272727273,0.136363636363636,0.25,0,0,0,0.215909090909091,0.170454545454545,0.0795454545454545,0,0,0
"279",17,0,0,0,7,20,44,15,0,0,0,16,13,44,88,0.193181818181818,0.0795454545454545,0.227272727272727,0,0,0,0.170454545454545,0.181818181818182,0.147727272727273,0,0,0
"280",9,0,0,0,9,18,36,20,0,0,0,19,10,49,85,0.105882352941176,0.105882352941176,0.211764705882353,0,0,0,0.235294117647059,0.223529411764706,0.117647058823529,0,0,0
"281",15,0,0,0,10,15,40,20,0,0,0,16,15,51,91,0.164835164835165,0.10989010989011,0.164835164835165,0,0,0,0.21978021978022,0.175824175824176,0.164835164835165,0,0,0
"282",15,0,0,0,11,21,47,16,0,0,0,18,8,42,89,0.168539325842697,0.123595505617978,0.235955056179775,0,0,0,0.179775280898876,0.202247191011236,0.0898876404494382,0,0,0
"283",13,0,0,0,10,25,48,24,0,0,0,20,8,52,100,0.13,0.1,0.25,0,0,0,0.24,0.2,0.08,0,0,0
"284",11,0,0,0,9,21,41,15,0,0,0,12,12,39,80,0.1375,0.1125,0.2625,0,0,0,0.1875,0.15,0.15,0,0,0
"285",16,0,0,0,12,24,52,19,0,0,0,16,8,43,95,0.168421052631579,0.126315789473684,0.252631578947368,0,0,0,0.2,0.168421052631579,0.0842105263157895,0,0,0
"286",3,0,0,0,10,16,29,22,0,0,0,13,10,45,74,0.0405405405405405,0.135135135135135,0.216216216216216,0,0,0,0.297297297297297,0.175675675675676,0.135135135135135,0,0,0
"287",2,0,0,0,8,13,23,20,0,0,0,19,14,53,76,0.0263157894736842,0.105263157894737,0.171052631578947,0,0,0,0.263157894736842,0.25,0.184210526315789,0,0,0
"288",6,0,0,0,0,5,11,10,0,0,0,14,19,43,54,0.111111111111111,0,0.0925925925925926,0,0,0,0.185185185185185,0.259259259259259,0.351851851851852,0,0,0
"289",2,0,0,0,1,4,7,0,0,0,0,23,21,44,51,0.0392156862745098,0.0196078431372549,0.0784313725490196,0,0,0,0,0.450980392156863,0.411764705882353,0,0,0
"290",0,0,0,0,1,6,7,0,0,0,0,2,10,12,19,0,0.0526315789473684,0.315789473684211,0,0,0,0,0.105263157894737,0.526315789473684,0,0,0
"291",0,0,0,0,3,5,8,0,0,0,0,0,5,5,13,0,0.230769230769231,0.384615384615385,0,0,0,0,0,0.384615384615385,0,0,0
"292",0,0,0,0,2,1,3,0,0,0,0,0,5,5,8,0,0.25,0.125,0,0,0,0,0,0.625,0,0,0
"293",0,0,0,0,0,3,3,0,0,0,0,2,3,5,8,0,0,0.375,0,0,0,0,0.25,0.375,0,0,0
"294",0,2,0,0,0,0,2,0,2,0,0,0,4,6,8,0,0,0,0,0,0.25,0,0,0.5,0,0,0.25
"295",2,6,0,1,2,0,11,0,11,0,3,0,0,14,25,0.08,0.08,0,0.04,0,0.24,0,0,0,0.12,0,0.44
"296",15,0,0,0,24,32,71,1,0,0,0,4,0,5,76,0.197368421052632,0.315789473684211,0.421052631578947,0,0,0,0.0131578947368421,0.0526315789473684,0,0,0,0
"297",21,0,0,0,25,27,73,10,0,0,0,7,0,17,90,0.233333333333333,0.277777777777778,0.3,0,0,0,0.111111111111111,0.0777777777777778,0,0,0,0
"298",14,0,0,0,16,24,54,15,0,0,0,9,8,32,86,0.162790697674419,0.186046511627907,0.27906976744186,0,0,0,0.174418604651163,0.104651162790698,0.0930232558139535,0,0,0
"299",6,0,0,0,9,14,29,22,0,0,0,13,14,49,78,0.0769230769230769,0.115384615384615,0.179487179487179,0,0,0,0.282051282051282,0.166666666666667,0.179487179487179,0,0,0
"300",14,0,0,0,9,23,46,20,0,0,0,21,8,49,95,0.147368421052632,0.0947368421052632,0.242105263157895,0,0,0,0.210526315789474,0.221052631578947,0.0842105263157895,0,0,0
"301",13,0,0,0,13,21,47,19,0,0,0,16,11,46,93,0.139784946236559,0.139784946236559,0.225806451612903,0,0,0,0.204301075268817,0.172043010752688,0.118279569892473,0,0,0
"302",16,0,0,0,14,24,54,15,0,0,0,13,8,36,90,0.177777777777778,0.155555555555556,0.266666666666667,0,0,0,0.166666666666667,0.144444444444444,0.0888888888888889,0,0,0
"303",14,0,0,0,6,21,41,19,0,0,0,14,10,43,84,0.166666666666667,0.0714285714285714,0.25,0,0,0,0.226190476190476,0.166666666666667,0.119047619047619,0,0,0
"304",13,0,0,0,10,14,37,18,0,0,0,17,17,52,89,0.146067415730337,0.112359550561798,0.157303370786517,0,0,0,0.202247191011236,0.191011235955056,0.191011235955056,0,0,0
"305",16,0,0,0,8,22,46,21,0,0,0,19,8,48,94,0.170212765957447,0.0851063829787234,0.234042553191489,0,0,0,0.223404255319149,0.202127659574468,0.0851063829787234,0,0,0
"306",13,0,0,0,11,23,47,14,0,0,0,16,6,36,83,0.156626506024096,0.132530120481928,0.27710843373494,0,0,0,0.168674698795181,0.192771084337349,0.072289156626506,0,0,0
"307",7,0,0,0,5,20,32,26,0,0,0,21,6,53,85,0.0823529411764706,0.0588235294117647,0.235294117647059,0,0,0,0.305882352941176,0.247058823529412,0.0705882352941176,0,0,0
"308",13,0,0,0,12,23,48,20,0,0,0,22,3,45,93,0.139784946236559,0.129032258064516,0.247311827956989,0,0,0,0.21505376344086,0.236559139784946,0.032258064516129,0,0,0
"309",14,0,0,0,16,16,46,17,0,0,0,13,9,39,85,0.164705882352941,0.188235294117647,0.188235294117647,0,0,0,0.2,0.152941176470588,0.105882352941176,0,0,0
"310",3,0,0,0,11,18,32,19,0,0,0,15,9,43,75,0.04,0.146666666666667,0.24,0,0,0,0.253333333333333,0.2,0.12,0,0,0
"311",4,0,0,0,4,12,20,22,0,0,0,19,15,56,76,0.0526315789473684,0.0526315789473684,0.157894736842105,0,0,0,0.289473684210526,0.25,0.197368421052632,0,0,0
"312",6,0,0,0,1,4,11,8,0,0,0,21,17,46,57,0.105263157894737,0.0175438596491228,0.0701754385964912,0,0,0,0.140350877192982,0.368421052631579,0.298245614035088,0,0,0
"313",4,0,0,0,2,4,10,0,0,0,0,18,23,41,51,0.0784313725490196,0.0392156862745098,0.0784313725490196,0,0,0,0,0.352941176470588,0.450980392156863,0,0,0
"314",0,0,0,0,1,5,6,0,0,0,0,5,6,11,17,0,0.0588235294117647,0.294117647058824,0,0,0,0,0.294117647058824,0.352941176470588,0,0,0
"315",0,0,0,0,3,7,10,0,0,0,0,2,4,6,16,0,0.1875,0.4375,0,0,0,0,0.125,0.25,0,0,0
"316",0,0,0,0,0,3,3,0,0,0,0,0,2,2,5,0,0,0.6,0,0,0,0,0,0.4,0,0,0
"317",0,0,0,0,2,2,4,0,0,0,0,2,4,6,10,0,0.2,0.2,0,0,0,0,0.2,0.4,0,0,0
"318",0,0,0,0,2,3,5,0,0,0,0,1,7,8,13,0,0.153846153846154,0.230769230769231,0,0,0,0,0.0769230769230769,0.538461538461538,0,0,0
"319",0,3,2,2,2,1,10,0,0,0,1,1,8,10,20,0,0.1,0.05,0.1,0.1,0.15,0,0.05,0.4,0.05,0,0
"320",0,24,9,13,0,0,46,0,1,0,11,0,0,12,58,0,0,0,0.224137931034483,0.155172413793103,0.413793103448276,0,0,0,0.189655172413793,0,0.0172413793103448
"321",8,17,8,7,7,9,56,4,1,0,4,2,0,11,67,0.119402985074627,0.104477611940299,0.134328358208955,0.104477611940299,0.119402985074627,0.253731343283582,0.0597014925373134,0.0298507462686567,0,0.0597014925373134,0,0.0149253731343284
"322",17,0,0,0,17,28,62,17,0,0,0,14,4,35,97,0.175257731958763,0.175257731958763,0.288659793814433,0,0,0,0.175257731958763,0.144329896907216,0.0412371134020619,0,0,0
"323",13,0,0,0,15,23,51,19,0,0,0,17,8,44,95,0.136842105263158,0.157894736842105,0.242105263157895,0,0,0,0.2,0.178947368421053,0.0842105263157895,0,0,0
"324",14,0,0,0,11,26,51,15,0,0,0,17,2,34,85,0.164705882352941,0.129411764705882,0.305882352941176,0,0,0,0.176470588235294,0.2,0.0235294117647059,0,0,0
"325",8,0,0,0,11,22,41,18,0,0,0,17,6,41,82,0.0975609756097561,0.134146341463415,0.268292682926829,0,0,0,0.219512195121951,0.207317073170732,0.0731707317073171,0,0,0
"326",11,0,0,0,13,22,46,18,0,0,0,14,10,42,88,0.125,0.147727272727273,0.25,0,0,0,0.204545454545455,0.159090909090909,0.113636363636364,0,0,0
"327",12,0,0,0,6,24,42,19,0,0,0,17,7,43,85,0.141176470588235,0.0705882352941176,0.282352941176471,0,0,0,0.223529411764706,0.2,0.0823529411764706,0,0,0
"328",12,0,0,0,13,17,42,20,0,0,0,15,14,49,91,0.131868131868132,0.142857142857143,0.186813186813187,0,0,0,0.21978021978022,0.164835164835165,0.153846153846154,0,0,0
"329",16,0,0,0,9,18,43,18,0,0,0,20,11,49,92,0.173913043478261,0.0978260869565217,0.195652173913043,0,0,0,0.195652173913043,0.217391304347826,0.119565217391304,0,0,0
"330",13,0,0,0,11,17,41,17,0,0,0,15,9,41,82,0.158536585365854,0.134146341463415,0.207317073170732,0,0,0,0.207317073170732,0.182926829268293,0.109756097560976,0,0,0
"331",7,0,0,0,6,19,32,19,0,0,0,14,11,44,76,0.0921052631578947,0.0789473684210526,0.25,0,0,0,0.25,0.184210526315789,0.144736842105263,0,0,0
"332",9,0,0,0,5,22,36,14,0,0,0,17,10,41,77,0.116883116883117,0.0649350649350649,0.285714285714286,0,0,0,0.181818181818182,0.220779220779221,0.12987012987013,0,0,0
"333",13,0,0,0,10,16,39,16,0,0,0,16,10,42,81,0.160493827160494,0.123456790123457,0.197530864197531,0,0,0,0.197530864197531,0.197530864197531,0.123456790123457,0,0,0
"334",3,0,0,0,10,20,33,14,0,0,0,10,8,32,65,0.0461538461538462,0.153846153846154,0.307692307692308,0,0,0,0.215384615384615,0.153846153846154,0.123076923076923,0,0,0
"335",4,0,0,0,4,8,16,14,0,0,0,18,16,48,64,0.0625,0.0625,0.125,0,0,0,0.21875,0.28125,0.25,0,0,0
"336",4,0,0,0,1,2,7,6,0,0,0,19,17,42,49,0.0816326530612245,0.0204081632653061,0.0408163265306122,0,0,0,0.122448979591837,0.387755102040816,0.346938775510204,0,0,0
"337",3,0,0,0,1,5,9,0,0,0,0,15,18,33,42,0.0714285714285714,0.0238095238095238,0.119047619047619,0,0,0,0,0.357142857142857,0.428571428571429,0,0,0
"338",0,0,0,0,0,9,9,0,0,0,0,0,8,8,17,0,0,0.529411764705882,0,0,0,0,0,0.470588235294118,0,0,0
"339",0,0,0,0,0,8,8,0,0,0,0,0,2,2,10,0,0,0.8,0,0,0,0,0,0.2,0,0,0
"340",0,0,0,0,0,2,2,0,0,0,0,0,3,3,5,0,0,0.4,0,0,0,0,0,0.6,0,0,0
"341",0,0,0,0,0,2,2,0,0,0,0,0,6,6,8,0,0,0.25,0,0,0,0,0,0.75,0,0,0
"342",0,0,0,0,0,4,4,0,0,0,0,0,12,12,16,0,0,0.25,0,0,0,0,0,0.75,0,0,0
"343",4,0,0,0,3,5,12,1,0,0,0,0,6,7,19,0.210526315789474,0.157894736842105,0.263157894736842,0,0,0,0.0526315789473684,0,0.315789473684211,0,0,0
"344",19,0,0,0,21,25,65,3,0,0,0,5,0,8,73,0.26027397260274,0.287671232876712,0.342465753424658,0,0,0,0.0410958904109589,0.0684931506849315,0,0,0,0
"345",15,0,0,0,26,30,71,9,0,0,0,4,0,13,84,0.178571428571429,0.30952380952381,0.357142857142857,0,0,0,0.107142857142857,0.0476190476190476,0,0,0,0
"346",12,0,0,0,18,28,58,12,0,0,0,14,4,30,88,0.136363636363636,0.204545454545455,0.318181818181818,0,0,0,0.136363636363636,0.159090909090909,0.0454545454545455,0,0,0
"347",3,0,0,0,10,17,30,23,0,0,0,15,11,49,79,0.0379746835443038,0.126582278481013,0.215189873417722,0,0,0,0.291139240506329,0.189873417721519,0.139240506329114,0,0,0
"348",15,0,0,0,7,21,43,18,0,0,0,18,9,45,88,0.170454545454545,0.0795454545454545,0.238636363636364,0,0,0,0.204545454545455,0.204545454545455,0.102272727272727,0,0,0
"349",13,0,0,0,9,22,44,20,0,0,0,20,7,47,91,0.142857142857143,0.0989010989010989,0.241758241758242,0,0,0,0.21978021978022,0.21978021978022,0.0769230769230769,0,0,0
"350",12,0,0,0,14,27,53,19,0,0,0,15,4,38,91,0.131868131868132,0.153846153846154,0.296703296703297,0,0,0,0.208791208791209,0.164835164835165,0.043956043956044,0,0,0
"351",12,0,0,0,10,22,44,19,0,0,0,16,8,43,87,0.137931034482759,0.114942528735632,0.252873563218391,0,0,0,0.218390804597701,0.183908045977011,0.0919540229885057,0,0,0
"352",12,0,0,0,12,19,43,19,0,0,0,14,8,41,84,0.142857142857143,0.142857142857143,0.226190476190476,0,0,0,0.226190476190476,0.166666666666667,0.0952380952380952,0,0,0
"353",11,0,0,0,6,18,35,21,0,0,0,19,12,52,87,0.126436781609195,0.0689655172413793,0.206896551724138,0,0,0,0.241379310344828,0.218390804597701,0.137931034482759,0,0,0
"354",17,0,0,0,11,25,53,17,0,0,0,19,9,45,98,0.173469387755102,0.112244897959184,0.255102040816327,0,0,0,0.173469387755102,0.193877551020408,0.0918367346938776,0,0,0
"355",7,0,0,0,6,21,34,23,0,0,0,17,11,51,85,0.0823529411764706,0.0705882352941176,0.247058823529412,0,0,0,0.270588235294118,0.2,0.129411764705882,0,0,0
"356",11,0,0,0,11,20,42,16,0,0,0,18,9,43,85,0.129411764705882,0.129411764705882,0.235294117647059,0,0,0,0.188235294117647,0.211764705882353,0.105882352941176,0,0,0
"357",12,0,0,0,15,23,50,21,0,0,0,16,8,45,95,0.126315789473684,0.157894736842105,0.242105263157895,0,0,0,0.221052631578947,0.168421052631579,0.0842105263157895,0,0,0
"358",5,0,0,0,10,25,40,18,0,0,0,15,5,38,78,0.0641025641025641,0.128205128205128,0.320512820512821,0,0,0,0.230769230769231,0.192307692307692,0.0641025641025641,0,0,0
"359",4,0,0,0,6,8,18,18,0,0,0,20,18,56,74,0.0540540540540541,0.0810810810810811,0.108108108108108,0,0,0,0.243243243243243,0.27027027027027,0.243243243243243,0,0,0
"360",9,0,0,0,1,1,11,7,0,0,0,16,18,41,52,0.173076923076923,0.0192307692307692,0.0192307692307692,0,0,0,0.134615384615385,0.307692307692308,0.346153846153846,0,0,0
"361",3,0,0,0,0,1,4,0,0,0,0,25,25,50,54,0.0555555555555556,0,0.0185185185185185,0,0,0,0,0.462962962962963,0.462962962962963,0,0,0
"362",0,0,0,0,0,10,10,0,0,0,0,2,13,15,25,0,0,0.4,0,0,0,0,0.08,0.52,0,0,0
"363",0,0,0,0,0,10,10,0,0,0,0,0,2,2,12,0,0,0.833333333333333,0,0,0,0,0,0.166666666666667,0,0,0
"364",0,0,0,0,0,1,1,0,0,0,0,0,3,3,4,0,0,0.25,0,0,0,0,0,0.75,0,0,0
"365",0,0,0,0,0,1,1,0,0,0,0,0,6,6,7,0,0,0.142857142857143,0,0,0,0,0,0.857142857142857,0,0,0
"366",0,0,0,0,0,4,4,0,0,0,0,0,7,7,11,0,0,0.363636363636364,0,0,0,0,0,0.636363636363636,0,0,0
"367",5,0,0,0,5,6,16,1,0,0,0,0,8,9,25,0.2,0.2,0.24,0,0,0,0.04,0,0.32,0,0,0
"368",13,0,0,0,14,32,59,1,0,0,0,4,1,6,65,0.2,0.215384615384615,0.492307692307692,0,0,0,0.0153846153846154,0.0615384615384615,0.0153846153846154,0,0,0
"369",19,0,0,0,26,33,78,7,0,0,0,2,1,10,88,0.215909090909091,0.295454545454545,0.375,0,0,0,0.0795454545454545,0.0227272727272727,0.0113636363636364,0,0,0
"370",11,0,0,0,17,28,56,13,0,0,0,15,3,31,87,0.126436781609195,0.195402298850575,0.32183908045977,0,0,0,0.149425287356322,0.172413793103448,0.0344827586206897,0,0,0
"371",5,0,0,0,7,19,31,16,0,0,0,15,12,43,74,0.0675675675675676,0.0945945945945946,0.256756756756757,0,0,0,0.216216216216216,0.202702702702703,0.162162162162162,0,0,0
"372",13,0,0,0,9,21,43,18,0,0,0,16,10,44,87,0.149425287356322,0.103448275862069,0.241379310344828,0,0,0,0.206896551724138,0.183908045977011,0.114942528735632,0,0,0
"373",13,0,0,0,8,23,44,20,0,0,0,16,9,45,89,0.146067415730337,0.0898876404494382,0.258426966292135,0,0,0,0.224719101123595,0.179775280898876,0.101123595505618,0,0,0
"374",14,0,0,0,15,26,55,17,0,0,0,14,3,34,89,0.157303370786517,0.168539325842697,0.292134831460674,0,0,0,0.191011235955056,0.157303370786517,0.0337078651685393,0,0,0
"375",11,0,0,0,10,23,44,17,0,0,0,16,11,44,88,0.125,0.113636363636364,0.261363636363636,0,0,0,0.193181818181818,0.181818181818182,0.125,0,0,0
"376",12,0,0,0,9,12,33,19,0,0,0,17,10,46,79,0.151898734177215,0.113924050632911,0.151898734177215,0,0,0,0.240506329113924,0.215189873417722,0.126582278481013,0,0,0
"377",16,0,0,0,6,15,37,21,0,0,0,22,17,60,97,0.164948453608247,0.0618556701030928,0.154639175257732,0,0,0,0.216494845360825,0.22680412371134,0.175257731958763,0,0,0
"378",13,0,0,0,16,25,54,20,0,0,0,19,5,44,98,0.13265306122449,0.163265306122449,0.255102040816327,0,0,0,0.204081632653061,0.193877551020408,0.0510204081632653,0,0,0
"379",8,0,0,0,8,24,40,24,0,0,0,22,8,54,94,0.0851063829787234,0.0851063829787234,0.25531914893617,0,0,0,0.25531914893617,0.234042553191489,0.0851063829787234,0,0,0
"380",14,0,0,0,13,25,52,19,0,0,0,20,8,47,99,0.141414141414141,0.131313131313131,0.252525252525253,0,0,0,0.191919191919192,0.202020202020202,0.0808080808080808,0,0,0
"381",13,0,0,0,15,26,54,21,0,0,0,18,6,45,99,0.131313131313131,0.151515151515152,0.262626262626263,0,0,0,0.212121212121212,0.181818181818182,0.0606060606060606,0,0,0
"382",5,0,0,0,12,21,38,20,0,0,0,16,7,43,81,0.0617283950617284,0.148148148148148,0.259259259259259,0,0,0,0.246913580246914,0.197530864197531,0.0864197530864197,0,0,0
"383",6,0,0,0,6,12,24,21,0,0,0,21,13,55,79,0.0759493670886076,0.0759493670886076,0.151898734177215,0,0,0,0.265822784810127,0.265822784810127,0.164556962025316,0,0,0
"384",4,0,0,0,0,3,7,10,0,0,0,15,17,42,49,0.0816326530612245,0,0.0612244897959184,0,0,0,0.204081632653061,0.306122448979592,0.346938775510204,0,0,0
"385",0,0,0,0,2,3,5,0,0,0,0,23,19,42,47,0,0.0425531914893617,0.0638297872340425,0,0,0,0,0.48936170212766,0.404255319148936,0,0,0
"386",0,0,0,0,4,8,12,0,0,0,0,12,10,22,34,0,0.117647058823529,0.235294117647059,0,0,0,0,0.352941176470588,0.294117647058824,0,0,0
"387",0,0,0,0,4,0,4,0,0,0,0,4,0,4,8,0,0.5,0,0,0,0,0,0.5,0,0,0,0
"388",0,0,0,0,3,0,3,0,0,0,0,4,0,4,7,0,0.428571428571429,0,0,0,0,0,0.571428571428571,0,0,0,0
"389",0,0,0,0,2,0,2,0,0,0,0,5,0,5,7,0,0.285714285714286,0,0,0,0,0,0.714285714285714,0,0,0,0
"390",0,0,0,0,2,0,2,0,0,0,0,10,0,10,12,0,0.166666666666667,0,0,0,0,0,0.833333333333333,0,0,0,0
"391",4,0,0,0,6,11,21,2,0,0,0,3,2,7,28,0.142857142857143,0.214285714285714,0.392857142857143,0,0,0,0.0714285714285714,0.107142857142857,0.0714285714285714,0,0,0
"392",15,0,0,0,15,34,64,1,0,0,0,3,0,4,68,0.220588235294118,0.220588235294118,0.5,0,0,0,0.0147058823529412,0.0441176470588235,0,0,0,0
"393",17,0,0,0,23,29,69,8,0,0,0,6,1,15,84,0.202380952380952,0.273809523809524,0.345238095238095,0,0,0,0.0952380952380952,0.0714285714285714,0.0119047619047619,0,0,0
"394",17,0,0,0,15,29,61,14,0,0,0,17,1,32,93,0.182795698924731,0.161290322580645,0.311827956989247,0,0,0,0.150537634408602,0.182795698924731,0.010752688172043,0,0,0
"395",6,0,0,0,8,18,32,22,0,0,0,18,11,51,83,0.072289156626506,0.0963855421686747,0.216867469879518,0,0,0,0.265060240963855,0.216867469879518,0.132530120481928,0,0,0
"396",13,0,0,0,8,23,44,21,0,0,0,17,9,47,91,0.142857142857143,0.0879120879120879,0.252747252747253,0,0,0,0.230769230769231,0.186813186813187,0.0989010989010989,0,0,0
"397",15,0,0,0,10,24,49,18,0,0,0,16,8,42,91,0.164835164835165,0.10989010989011,0.263736263736264,0,0,0,0.197802197802198,0.175824175824176,0.0879120879120879,0,0,0
"398",14,0,0,0,11,16,41,18,0,0,0,15,12,45,86,0.162790697674419,0.127906976744186,0.186046511627907,0,0,0,0.209302325581395,0.174418604651163,0.13953488372093,0,0,0
"399",17,0,0,0,6,22,45,18,0,0,0,21,7,46,91,0.186813186813187,0.0659340659340659,0.241758241758242,0,0,0,0.197802197802198,0.230769230769231,0.0769230769230769,0,0,0
"400",13,0,0,0,14,18,45,20,0,0,0,18,12,50,95,0.136842105263158,0.147368421052632,0.189473684210526,0,0,0,0.210526315789474,0.189473684210526,0.126315789473684,0,0,0
"401",17,0,0,0,8,23,48,22,0,0,0,20,5,47,95,0.178947368421053,0.0842105263157895,0.242105263157895,0,0,0,0.231578947368421,0.210526315789474,0.0526315789473684,0,0,0
"402",10,0,0,0,11,24,45,16,0,0,0,17,6,39,84,0.119047619047619,0.130952380952381,0.285714285714286,0,0,0,0.19047619047619,0.202380952380952,0.0714285714285714,0,0,0
"403",12,0,0,0,8,19,39,20,0,0,0,20,13,53,92,0.130434782608696,0.0869565217391304,0.206521739130435,0,0,0,0.217391304347826,0.217391304347826,0.141304347826087,0,0,0
"404",13,0,0,0,6,23,42,17,0,0,0,15,10,42,84,0.154761904761905,0.0714285714285714,0.273809523809524,0,0,0,0.202380952380952,0.178571428571429,0.119047619047619,0,0,0
"405",0,25,8,10,0,0,43,2,2,13,16,4,0,37,80,0,0,0,0.125,0.1,0.3125,0.025,0.05,0,0.2,0.1625,0.025
"406",0,25,9,10,0,0,44,0,5,20,17,0,0,42,86,0,0,0,0.116279069767442,0.104651162790698,0.290697674418605,0,0,0,0.197674418604651,0.232558139534884,0.0581395348837209
"407",0,16,3,5,0,0,24,0,6,22,23,0,0,51,75,0,0,0,0.0666666666666667,0.04,0.213333333333333,0,0,0,0.306666666666667,0.293333333333333,0.08
"408",0,11,0,1,0,0,12,0,5,15,20,1,0,41,53,0,0,0,0.0188679245283019,0,0.207547169811321,0,0.0188679245283019,0,0.377358490566038,0.283018867924528,0.0943396226415094
"409",0,4,0,0,2,2,8,0,5,18,20,2,0,45,53,0,0.0377358490566038,0.0377358490566038,0,0,0.0754716981132075,0,0.0377358490566038,0,0.377358490566038,0.339622641509434,0.0943396226415094
"410",0,0,0,0,4,2,6,0,0,0,0,17,12,29,35,0,0.114285714285714,0.0571428571428571,0,0,0,0,0.485714285714286,0.342857142857143,0,0,0
"411",0,0,0,0,9,0,9,0,0,0,0,4,0,4,13,0,0.692307692307692,0,0,0,0,0,0.307692307692308,0,0,0,0
"412",0,0,0,0,3,0,3,0,0,0,0,2,0,2,5,0,0.6,0,0,0,0,0,0.4,0,0,0,0
"413",0,0,0,0,2,0,2,0,0,0,0,7,0,7,9,0,0.222222222222222,0,0,0,0,0,0.777777777777778,0,0,0,0
"414",0,0,0,0,3,0,3,0,0,0,0,7,0,7,10,0,0.3,0,0,0,0,0,0.7,0,0,0,0
"415",4,0,0,0,7,5,16,1,0,0,0,8,0,9,25,0.16,0.28,0.2,0,0,0,0.04,0.32,0,0,0,0
"416",16,0,0,0,16,34,66,4,0,0,0,3,0,7,73,0.219178082191781,0.219178082191781,0.465753424657534,0,0,0,0.0547945205479452,0.0410958904109589,0,0,0,0
"417",15,0,0,0,18,30,63,6,0,0,0,7,0,13,76,0.197368421052632,0.236842105263158,0.394736842105263,0,0,0,0.0789473684210526,0.0921052631578947,0,0,0,0
"418",13,0,0,0,14,26,53,16,0,0,0,11,5,32,85,0.152941176470588,0.164705882352941,0.305882352941176,0,0,0,0.188235294117647,0.129411764705882,0.0588235294117647,0,0,0
"419",7,0,0,0,5,15,27,18,0,0,0,16,15,49,76,0.0921052631578947,0.0657894736842105,0.197368421052632,0,0,0,0.236842105263158,0.210526315789474,0.197368421052632,0,0,0
"420",14,0,0,0,8,20,42,18,0,0,0,15,10,43,85,0.164705882352941,0.0941176470588235,0.235294117647059,0,0,0,0.211764705882353,0.176470588235294,0.117647058823529,0,0,0
"421",11,1,1,1,2,17,33,19,0,0,0,18,8,45,78,0.141025641025641,0.0256410256410256,0.217948717948718,0.0128205128205128,0.0128205128205128,0.0128205128205128,0.243589743589744,0.230769230769231,0.102564102564103,0,0,0
"422",0,25,5,13,0,0,43,0,0,19,17,0,0,36,79,0,0,0,0.164556962025316,0.0632911392405063,0.316455696202532,0,0,0,0.215189873417722,0.240506329113924,0
"423",0,22,16,15,0,0,53,0,6,14,20,0,0,40,93,0,0,0,0.161290322580645,0.172043010752688,0.236559139784946,0,0,0,0.21505376344086,0.150537634408602,0.0645161290322581
"424",0,22,11,10,0,0,43,0,9,16,23,0,0,48,91,0,0,0,0.10989010989011,0.120879120879121,0.241758241758242,0,0,0,0.252747252747253,0.175824175824176,0.0989010989010989
"425",0,21,7,17,0,0,45,0,8,20,21,0,0,49,94,0,0,0,0.180851063829787,0.074468085106383,0.223404255319149,0,0,0,0.223404255319149,0.212765957446809,0.0851063829787234
"426",0,23,10,15,0,0,48,0,6,18,19,0,0,43,91,0,0,0,0.164835164835165,0.10989010989011,0.252747252747253,0,0,0,0.208791208791209,0.197802197802198,0.0659340659340659
"427",5,7,7,6,7,3,35,5,9,11,14,4,4,47,82,0.0609756097560976,0.0853658536585366,0.0365853658536585,0.0731707317073171,0.0853658536585366,0.0853658536585366,0.0609756097560976,0.0487804878048781,0.0487804878048781,0.170731707317073,0.134146341463415,0.109756097560976
"428",18,0,0,0,9,29,56,15,0,0,0,19,6,40,96,0.1875,0.09375,0.302083333333333,0,0,0,0.15625,0.197916666666667,0.0625,0,0,0
"429",15,0,0,0,14,24,53,18,0,0,0,17,9,44,97,0.154639175257732,0.144329896907216,0.247422680412371,0,0,0,0.185567010309278,0.175257731958763,0.0927835051546392,0,0,0
"430",9,0,0,0,11,11,31,16,0,0,0,13,12,41,72,0.125,0.152777777777778,0.152777777777778,0,0,0,0.222222222222222,0.180555555555556,0.166666666666667,0,0,0
"431",13,0,0,0,12,5,30,18,0,0,0,20,22,60,90,0.144444444444444,0.133333333333333,0.0555555555555556,0,0,0,0.2,0.222222222222222,0.244444444444444,0,0,0
"432",10,0,0,0,1,0,11,8,0,0,0,17,15,40,51,0.196078431372549,0.0196078431372549,0,0,0,0,0.156862745098039,0.333333333333333,0.294117647058824,0,0,0
"433",9,0,0,0,0,0,9,0,0,0,0,29,26,55,64,0.140625,0,0,0,0,0,0,0.453125,0.40625,0,0,0
"434",0,0,0,0,2,7,9,0,0,0,0,7,10,17,26,0,0.0769230769230769,0.269230769230769,0,0,0,0,0.269230769230769,0.384615384615385,0,0,0
"435",0,0,0,0,3,4,7,0,0,0,0,5,8,13,20,0,0.15,0.2,0,0,0,0,0.25,0.4,0,0,0
"436",0,0,0,0,0,1,1,0,0,0,0,2,4,6,7,0,0,0.142857142857143,0,0,0,0,0.285714285714286,0.571428571428571,0,0,0
"437",0,0,0,0,1,4,5,0,0,0,0,4,5,9,14,0,0.0714285714285714,0.285714285714286,0,0,0,0,0.285714285714286,0.357142857142857,0,0,0
"438",0,0,0,0,1,2,3,0,0,0,0,0,6,6,9,0,0.111111111111111,0.222222222222222,0,0,0,0,0,0.666666666666667,0,0,0
"439",3,0,0,0,4,7,14,0,0,0,0,1,5,6,20,0.15,0.2,0.35,0,0,0,0,0.05,0.25,0,0,0
"440",17,0,0,0,16,27,60,1,0,0,0,4,2,7,67,0.253731343283582,0.238805970149254,0.402985074626866,0,0,0,0.0149253731343284,0.0597014925373134,0.0298507462686567,0,0,0
"441",17,0,0,0,20,31,68,6,0,0,0,6,0,12,80,0.2125,0.25,0.3875,0,0,0,0.075,0.075,0,0,0,0
"442",16,0,0,0,18,25,59,16,0,0,0,13,4,33,92,0.173913043478261,0.195652173913043,0.271739130434783,0,0,0,0.173913043478261,0.141304347826087,0.0434782608695652,0,0,0
"443",6,0,0,0,10,20,36,22,0,0,0,16,8,46,82,0.0731707317073171,0.121951219512195,0.24390243902439,0,0,0,0.268292682926829,0.195121951219512,0.0975609756097561,0,0,0
"444",10,0,0,0,7,21,38,20,0,0,0,19,9,48,86,0.116279069767442,0.0813953488372093,0.244186046511628,0,0,0,0.232558139534884,0.22093023255814,0.104651162790698,0,0,0
"445",14,0,0,0,12,23,49,18,0,0,0,19,9,46,95,0.147368421052632,0.126315789473684,0.242105263157895,0,0,0,0.189473684210526,0.2,0.0947368421052632,0,0,0
"446",10,0,0,0,17,25,52,18,0,0,0,15,4,37,89,0.112359550561798,0.191011235955056,0.280898876404494,0,0,0,0.202247191011236,0.168539325842697,0.0449438202247191,0,0,0
"447",13,0,0,0,6,21,40,20,0,0,0,18,7,45,85,0.152941176470588,0.0705882352941176,0.247058823529412,0,0,0,0.235294117647059,0.211764705882353,0.0823529411764706,0,0,0
"448",9,0,0,0,6,20,35,22,0,0,0,21,10,53,88,0.102272727272727,0.0681818181818182,0.227272727272727,0,0,0,0.25,0.238636363636364,0.113636363636364,0,0,0
"449",11,0,0,0,11,25,47,21,0,0,0,21,6,48,95,0.115789473684211,0.115789473684211,0.263157894736842,0,0,0,0.221052631578947,0.221052631578947,0.0631578947368421,0,0,0
"450",11,0,0,0,8,25,44,17,0,0,0,21,9,47,91,0.120879120879121,0.0879120879120879,0.274725274725275,0,0,0,0.186813186813187,0.230769230769231,0.0989010989010989,0,0,0
"451",19,0,0,0,13,21,53,17,0,0,0,21,11,49,102,0.186274509803922,0.127450980392157,0.205882352941176,0,0,0,0.166666666666667,0.205882352941176,0.107843137254902,0,0,0
"452",5,4,3,2,7,18,39,15,1,0,1,14,5,36,75,0.0666666666666667,0.0933333333333333,0.24,0.0266666666666667,0.04,0.0533333333333333,0.2,0.186666666666667,0.0666666666666667,0.0133333333333333,0,0.0133333333333333
"453",0,29,9,8,0,0,46,0,3,20,24,0,0,47,93,0,0,0,0.0860215053763441,0.0967741935483871,0.311827956989247,0,0,0,0.258064516129032,0.21505376344086,0.032258064516129
"454",8,9,6,3,6,10,42,7,4,7,7,8,5,38,80,0.1,0.075,0.125,0.0375,0.075,0.1125,0.0875,0.1,0.0625,0.0875,0.0875,0.05
"455",7,0,0,0,9,16,32,21,0,0,0,21,15,57,89,0.0786516853932584,0.101123595505618,0.179775280898876,0,0,0,0.235955056179775,0.235955056179775,0.168539325842697,0,0,0
"456",6,0,0,0,3,3,12,9,0,0,0,17,17,43,55,0.109090909090909,0.0545454545454545,0.0545454545454545,0,0,0,0.163636363636364,0.309090909090909,0.309090909090909,0,0,0
"457",3,0,0,0,2,2,7,0,0,0,0,25,25,50,57,0.0526315789473684,0.0350877192982456,0.0350877192982456,0,0,0,0,0.43859649122807,0.43859649122807,0,0,0
"458",0,0,0,0,1,7,8,0,0,0,0,7,10,17,25,0,0.04,0.28,0,0,0,0,0.28,0.4,0,0,0
"459",0,0,0,0,1,2,3,0,0,0,0,4,3,7,10,0,0.1,0.2,0,0,0,0,0.4,0.3,0,0,0
"460",0,0,0,0,2,2,4,0,0,0,0,0,5,5,9,0,0.222222222222222,0.222222222222222,0,0,0,0,0,0.555555555555556,0,0,0
"461",0,0,0,0,1,3,4,0,0,0,0,1,3,4,8,0,0.125,0.375,0,0,0,0,0.125,0.375,0,0,0
"462",0,0,0,0,0,1,1,0,0,0,0,0,7,7,8,0,0,0.125,0,0,0,0,0,0.875,0,0,0
"463",4,0,0,0,3,7,14,3,0,0,0,1,5,9,23,0.173913043478261,0.130434782608696,0.304347826086957,0,0,0,0.130434782608696,0.0434782608695652,0.217391304347826,0,0,0
"464",13,0,0,0,13,31,57,2,0,0,0,4,0,6,63,0.206349206349206,0.206349206349206,0.492063492063492,0,0,0,0.0317460317460317,0.0634920634920635,0,0,0,0
"465",23,0,0,0,21,39,83,8,0,0,0,6,0,14,97,0.237113402061856,0.216494845360825,0.402061855670103,0,0,0,0.0824742268041237,0.0618556701030928,0,0,0,0
"466",12,0,0,0,18,25,55,13,0,0,0,15,5,33,88,0.136363636363636,0.204545454545455,0.284090909090909,0,0,0,0.147727272727273,0.170454545454545,0.0568181818181818,0,0,0
"467",7,0,0,0,7,18,32,22,0,0,0,17,11,50,82,0.0853658536585366,0.0853658536585366,0.219512195121951,0,0,0,0.268292682926829,0.207317073170732,0.134146341463415,0,0,0
"468",14,0,0,0,8,19,41,20,0,0,0,15,12,47,88,0.159090909090909,0.0909090909090909,0.215909090909091,0,0,0,0.227272727272727,0.170454545454545,0.136363636363636,0,0,0
"469",13,0,0,0,10,27,50,21,0,0,0,18,1,40,90,0.144444444444444,0.111111111111111,0.3,0,0,0,0.233333333333333,0.2,0.0111111111111111,0,0,0
"470",11,0,0,0,13,23,47,22,0,0,0,16,3,41,88,0.125,0.147727272727273,0.261363636363636,0,0,0,0.25,0.181818181818182,0.0340909090909091,0,0,0
"471",11,0,0,0,6,31,48,23,0,0,0,18,1,42,90,0.122222222222222,0.0666666666666667,0.344444444444444,0,0,0,0.255555555555556,0.2,0.0111111111111111,0,0,0
"472",8,0,0,0,6,19,33,24,0,0,0,20,2,46,79,0.10126582278481,0.0759493670886076,0.240506329113924,0,0,0,0.30379746835443,0.253164556962025,0.0253164556962025,0,0,0
"473",8,0,0,0,8,30,46,24,0,0,0,25,0,49,95,0.0842105263157895,0.0842105263157895,0.315789473684211,0,0,0,0.252631578947368,0.263157894736842,0,0,0,0
"474",11,0,0,0,12,27,50,20,0,0,0,18,2,40,90,0.122222222222222,0.133333333333333,0.3,0,0,0,0.222222222222222,0.2,0.0222222222222222,0,0,0
"475",8,0,0,0,6,22,36,23,0,0,0,21,4,48,84,0.0952380952380952,0.0714285714285714,0.261904761904762,0,0,0,0.273809523809524,0.25,0.0476190476190476,0,0,0
"476",10,0,0,0,9,22,41,21,0,0,0,22,5,48,89,0.112359550561798,0.101123595505618,0.247191011235955,0,0,0,0.235955056179775,0.247191011235955,0.0561797752808989,0,0,0
"477",12,0,0,0,17,24,53,21,0,0,0,20,2,43,96,0.125,0.177083333333333,0.25,0,0,0,0.21875,0.208333333333333,0.0208333333333333,0,0,0
"478",3,0,0,0,13,19,35,22,0,0,0,16,9,47,82,0.0365853658536585,0.158536585365854,0.231707317073171,0,0,0,0.268292682926829,0.195121951219512,0.109756097560976,0,0,0
"479",6,0,0,0,10,18,34,23,0,0,0,20,10,53,87,0.0689655172413793,0.114942528735632,0.206896551724138,0,0,0,0.264367816091954,0.229885057471264,0.114942528735632,0,0,0
"480",4,0,0,0,1,4,9,9,0,0,1,17,16,43,52,0.0769230769230769,0.0192307692307692,0.0769230769230769,0,0,0,0.173076923076923,0.326923076923077,0.307692307692308,0.0192307692307692,0,0
"481",6,0,0,0,2,0,8,0,0,0,0,26,26,52,60,0.1,0.0333333333333333,0,0,0,0,0,0.433333333333333,0.433333333333333,0,0,0
"482",0,0,0,0,2,9,11,0,0,0,0,4,11,15,26,0,0.0769230769230769,0.346153846153846,0,0,0,0,0.153846153846154,0.423076923076923,0,0,0
"483",0,0,0,0,2,4,6,0,0,0,0,2,7,9,15,0,0.133333333333333,0.266666666666667,0,0,0,0,0.133333333333333,0.466666666666667,0,0,0
"484",0,0,0,0,1,2,3,0,0,0,0,1,3,4,7,0,0.142857142857143,0.285714285714286,0,0,0,0,0.142857142857143,0.428571428571429,0,0,0
"485",0,0,0,0,0,3,3,0,0,0,0,0,7,7,10,0,0,0.3,0,0,0,0,0,0.7,0,0,0
"486",0,0,0,0,0,4,4,0,0,0,0,0,8,8,12,0,0,0.333333333333333,0,0,0,0,0,0.666666666666667,0,0,0
"487",3,0,0,0,7,4,14,2,0,0,0,0,6,8,22,0.136363636363636,0.318181818181818,0.181818181818182,0,0,0,0.0909090909090909,0,0.272727272727273,0,0,0
"488",12,0,0,0,12,27,51,2,0,0,0,6,1,9,60,0.2,0.2,0.45,0,0,0,0.0333333333333333,0.1,0.0166666666666667,0,0,0
"489",22,0,0,0,25,36,83,9,0,0,0,5,0,14,97,0.22680412371134,0.257731958762887,0.371134020618557,0,0,0,0.0927835051546392,0.0515463917525773,0,0,0,0
"490",21,0,0,0,17,29,67,15,0,0,0,14,2,31,98,0.214285714285714,0.173469387755102,0.295918367346939,0,0,0,0.153061224489796,0.142857142857143,0.0204081632653061,0,0,0
"491",4,0,0,0,6,23,33,24,0,0,0,26,2,52,85,0.0470588235294118,0.0705882352941176,0.270588235294118,0,0,0,0.282352941176471,0.305882352941176,0.0235294117647059,0,0,0
"492",10,0,0,0,10,24,44,21,0,0,0,19,4,44,88,0.113636363636364,0.113636363636364,0.272727272727273,0,0,0,0.238636363636364,0.215909090909091,0.0454545454545455,0,0,0
"493",11,0,0,0,8,32,51,23,0,0,0,20,1,44,95,0.115789473684211,0.0842105263157895,0.336842105263158,0,0,0,0.242105263157895,0.210526315789474,0.0105263157894737,0,0,0
"494",12,0,0,0,13,25,50,22,0,0,0,18,1,41,91,0.131868131868132,0.142857142857143,0.274725274725275,0,0,0,0.241758241758242,0.197802197802198,0.010989010989011,0,0,0
"495",13,0,0,0,10,22,45,15,0,0,0,19,9,43,88,0.147727272727273,0.113636363636364,0.25,0,0,0,0.170454545454545,0.215909090909091,0.102272727272727,0,0,0
"496",11,0,0,0,10,18,39,25,0,0,0,22,4,51,90,0.122222222222222,0.111111111111111,0.2,0,0,0,0.277777777777778,0.244444444444444,0.0444444444444444,0,0,0
"497",11,0,0,0,9,31,51,23,0,0,0,24,2,49,100,0.11,0.09,0.31,0,0,0,0.23,0.24,0.02,0,0,0
"498",8,0,0,0,11,32,51,24,0,0,0,22,1,47,98,0.0816326530612245,0.112244897959184,0.326530612244898,0,0,0,0.244897959183673,0.224489795918367,0.0102040816326531,0,0,0
"499",7,0,0,0,10,28,45,26,0,0,0,23,0,49,94,0.074468085106383,0.106382978723404,0.297872340425532,0,0,0,0.276595744680851,0.24468085106383,0,0,0,0
"500",5,0,0,0,4,25,34,25,0,0,0,22,1,48,82,0.0609756097560976,0.0487804878048781,0.304878048780488,0,0,0,0.304878048780488,0.268292682926829,0.0121951219512195,0,0,0
"501",11,0,0,0,10,32,53,22,0,0,0,22,0,44,97,0.11340206185567,0.103092783505155,0.329896907216495,0,0,0,0.22680412371134,0.22680412371134,0,0,0,0
"502",3,0,0,0,11,27,41,25,0,0,0,20,1,46,87,0.0344827586206897,0.126436781609195,0.310344827586207,0,0,0,0.28735632183908,0.229885057471264,0.0114942528735632,0,0,0
"503",2,0,0,0,4,22,28,26,0,0,0,27,2,55,83,0.0240963855421687,0.0481927710843374,0.265060240963855,0,0,0,0.313253012048193,0.325301204819277,0.0240963855421687,0,0,0
"504",5,0,0,0,3,5,13,12,0,0,0,25,14,51,64,0.078125,0.046875,0.078125,0,0,0,0.1875,0.390625,0.21875,0,0,0
"505",6,0,0,0,1,0,7,0,0,0,0,24,25,49,56,0.107142857142857,0.0178571428571429,0,0,0,0,0,0.428571428571429,0.446428571428571,0,0,0
"506",0,0,0,0,1,7,8,0,0,0,0,7,9,16,24,0,0.0416666666666667,0.291666666666667,0,0,0,0,0.291666666666667,0.375,0,0,0
"507",0,0,0,0,2,7,9,0,0,0,0,1,3,4,13,0,0.153846153846154,0.538461538461538,0,0,0,0,0.0769230769230769,0.230769230769231,0,0,0
"508",0,0,0,0,1,2,3,0,0,0,0,2,1,3,6,0,0.166666666666667,0.333333333333333,0,0,0,0,0.333333333333333,0.166666666666667,0,0,0
"509",0,0,0,0,1,1,2,0,0,0,0,3,7,10,12,0,0.0833333333333333,0.0833333333333333,0,0,0,0,0.25,0.583333333333333,0,0,0
"510",0,0,0,0,4,0,4,0,0,0,0,0,7,7,11,0,0.363636363636364,0,0,0,0,0,0,0.636363636363636,0,0,0
"511",6,0,0,0,6,9,21,1,0,0,0,2,5,8,29,0.206896551724138,0.206896551724138,0.310344827586207,0,0,0,0.0344827586206897,0.0689655172413793,0.172413793103448,0,0,0
"512",19,0,0,0,12,30,61,3,0,0,0,2,0,5,66,0.287878787878788,0.181818181818182,0.454545454545455,0,0,0,0.0454545454545455,0.0303030303030303,0,0,0,0
"513",15,0,0,0,22,31,68,10,0,0,0,5,0,15,83,0.180722891566265,0.265060240963855,0.373493975903614,0,0,0,0.120481927710843,0.0602409638554217,0,0,0,0
"514",12,0,0,0,15,28,55,18,0,0,0,15,2,35,90,0.133333333333333,0.166666666666667,0.311111111111111,0,0,0,0.2,0.166666666666667,0.0222222222222222,0,0,0
"515",7,0,0,0,7,24,38,23,0,0,0,23,2,48,86,0.0813953488372093,0.0813953488372093,0.27906976744186,0,0,0,0.267441860465116,0.267441860465116,0.0232558139534884,0,0,0
"516",10,0,0,0,13,25,48,23,0,0,0,20,3,46,94,0.106382978723404,0.138297872340426,0.265957446808511,0,0,0,0.24468085106383,0.212765957446809,0.0319148936170213,0,0,0
"517",12,0,0,0,11,22,45,17,0,0,0,15,10,42,87,0.137931034482759,0.126436781609195,0.252873563218391,0,0,0,0.195402298850575,0.172413793103448,0.114942528735632,0,0,0
"518",14,0,0,0,9,21,44,18,0,0,0,14,9,41,85,0.164705882352941,0.105882352941176,0.247058823529412,0,0,0,0.211764705882353,0.164705882352941,0.105882352941176,0,0,0
"519",15,0,0,0,12,21,48,18,0,0,0,15,8,41,89,0.168539325842697,0.134831460674157,0.235955056179775,0,0,0,0.202247191011236,0.168539325842697,0.0898876404494382,0,0,0
"520",11,0,0,0,11,17,39,18,0,0,0,14,15,47,86,0.127906976744186,0.127906976744186,0.197674418604651,0,0,0,0.209302325581395,0.162790697674419,0.174418604651163,0,0,0
"521",16,0,0,0,7,25,48,20,0,0,0,19,10,49,97,0.164948453608247,0.0721649484536082,0.257731958762887,0,0,0,0.206185567010309,0.195876288659794,0.103092783505155,0,0,0
"522",13,0,0,0,11,23,47,18,0,0,0,18,6,42,89,0.146067415730337,0.123595505617978,0.258426966292135,0,0,0,0.202247191011236,0.202247191011236,0.0674157303370786,0,0,0
"523",11,0,0,0,9,24,44,22,0,0,0,18,0,40,84,0.130952380952381,0.107142857142857,0.285714285714286,0,0,0,0.261904761904762,0.214285714285714,0,0,0,0
"524",4,0,0,0,7,30,41,24,0,0,0,25,0,49,90,0.0444444444444444,0.0777777777777778,0.333333333333333,0,0,0,0.266666666666667,0.277777777777778,0,0,0,0
"525",10,0,0,0,11,22,43,21,0,0,0,21,0,42,85,0.117647058823529,0.129411764705882,0.258823529411765,0,0,0,0.247058823529412,0.247058823529412,0,0,0,0
"526",2,0,0,0,12,23,37,22,0,0,0,18,1,41,78,0.0256410256410256,0.153846153846154,0.294871794871795,0,0,0,0.282051282051282,0.230769230769231,0.0128205128205128,0,0,0
"527",4,0,0,0,4,12,20,22,0,0,0,25,2,49,69,0.0579710144927536,0.0579710144927536,0.173913043478261,0,0,0,0.318840579710145,0.36231884057971,0.0289855072463768,0,0,0
"528",6,0,0,0,1,5,12,12,0,0,0,20,10,42,54,0.111111111111111,0.0185185185185185,0.0925925925925926,0,0,0,0.222222222222222,0.37037037037037,0.185185185185185,0,0,0
"529",4,0,0,0,1,1,6,0,0,0,0,22,21,43,49,0.0816326530612245,0.0204081632653061,0.0204081632653061,0,0,0,0,0.448979591836735,0.428571428571429,0,0,0
"530",0,0,0,0,2,6,8,0,0,0,0,11,9,20,28,0,0.0714285714285714,0.214285714285714,0,0,0,0,0.392857142857143,0.321428571428571,0,0,0
"531",0,0,0,0,3,6,9,0,0,0,0,2,4,6,15,0,0.2,0.4,0,0,0,0,0.133333333333333,0.266666666666667,0,0,0
"532",0,0,0,0,1,2,3,0,0,0,0,1,2,3,6,0,0.166666666666667,0.333333333333333,0,0,0,0,0.166666666666667,0.333333333333333,0,0,0
"533",0,0,0,0,0,3,3,0,0,0,0,1,3,4,7,0,0,0.428571428571429,0,0,0,0,0.142857142857143,0.428571428571429,0,0,0
"534",0,0,0,0,0,2,2,0,0,0,0,0,8,8,10,0,0,0.2,0,0,0,0,0,0.8,0,0,0
"535",3,0,0,0,7,7,17,0,0,0,0,1,8,9,26,0.115384615384615,0.269230769230769,0.269230769230769,0,0,0,0,0.0384615384615385,0.307692307692308,0,0,0
"536",15,0,0,0,22,27,64,1,0,0,0,4,0,5,69,0.217391304347826,0.318840579710145,0.391304347826087,0,0,0,0.0144927536231884,0.0579710144927536,0,0,0,0
"537",19,0,0,0,24,26,69,8,0,0,0,4,0,12,81,0.234567901234568,0.296296296296296,0.320987654320988,0,0,0,0.0987654320987654,0.0493827160493827,0,0,0,0
"538",16,0,0,0,12,22,50,14,0,0,0,13,5,32,82,0.195121951219512,0.146341463414634,0.268292682926829,0,0,0,0.170731707317073,0.158536585365854,0.0609756097560976,0,0,0
"539",5,0,0,0,7,18,30,19,0,0,0,16,12,47,77,0.0649350649350649,0.0909090909090909,0.233766233766234,0,0,0,0.246753246753247,0.207792207792208,0.155844155844156,0,0,0
"540",14,0,0,0,8,27,49,22,0,0,0,15,4,41,90,0.155555555555556,0.0888888888888889,0.3,0,0,0,0.244444444444444,0.166666666666667,0.0444444444444444,0,0,0
"541",9,0,0,0,8,26,43,23,0,0,0,23,1,47,90,0.1,0.0888888888888889,0.288888888888889,0,0,0,0.255555555555556,0.255555555555556,0.0111111111111111,0,0,0
"542",16,0,0,0,14,24,54,20,0,0,0,13,5,38,92,0.173913043478261,0.152173913043478,0.260869565217391,0,0,0,0.217391304347826,0.141304347826087,0.0543478260869565,0,0,0
"543",13,0,0,0,11,21,45,20,0,0,0,20,1,41,86,0.151162790697674,0.127906976744186,0.244186046511628,0,0,0,0.232558139534884,0.232558139534884,0.0116279069767442,0,0,0
"544",9,0,0,0,9,19,37,23,0,0,0,21,4,48,85,0.105882352941176,0.105882352941176,0.223529411764706,0,0,0,0.270588235294118,0.247058823529412,0.0470588235294118,0,0,0
"545",7,0,0,0,8,24,39,20,0,0,0,25,6,51,90,0.0777777777777778,0.0888888888888889,0.266666666666667,0,0,0,0.222222222222222,0.277777777777778,0.0666666666666667,0,0,0
"546",12,0,0,0,8,26,46,23,0,0,0,20,5,48,94,0.127659574468085,0.0851063829787234,0.276595744680851,0,0,0,0.24468085106383,0.212765957446809,0.0531914893617021,0,0,0
"547",11,0,0,0,11,25,47,22,0,0,0,20,5,47,94,0.117021276595745,0.117021276595745,0.265957446808511,0,0,0,0.234042553191489,0.212765957446809,0.0531914893617021,0,0,0
"548",11,0,0,0,11,21,43,21,0,0,0,16,12,49,92,0.119565217391304,0.119565217391304,0.228260869565217,0,0,0,0.228260869565217,0.173913043478261,0.130434782608696,0,0,0
"549",12,0,0,0,11,26,49,20,0,0,0,17,8,45,94,0.127659574468085,0.117021276595745,0.276595744680851,0,0,0,0.212765957446809,0.180851063829787,0.0851063829787234,0,0,0
"550",7,0,0,0,15,18,40,19,0,0,0,14,12,45,85,0.0823529411764706,0.176470588235294,0.211764705882353,0,0,0,0.223529411764706,0.164705882352941,0.141176470588235,0,0,0
"551",3,0,0,0,7,14,24,17,0,0,0,18,18,53,77,0.038961038961039,0.0909090909090909,0.181818181818182,0,0,0,0.220779220779221,0.233766233766234,0.233766233766234,0,0,0
"552",2,0,0,0,1,1,4,8,0,0,0,18,21,47,51,0.0392156862745098,0.0196078431372549,0.0196078431372549,0,0,0,0.156862745098039,0.352941176470588,0.411764705882353,0,0,0
"553",2,0,0,0,2,2,6,0,0,0,0,21,22,43,49,0.0408163265306122,0.0408163265306122,0.0408163265306122,0,0,0,0,0.428571428571429,0.448979591836735,0,0,0
"554",0,0,0,0,2,7,9,0,0,0,0,5,7,12,21,0,0.0952380952380952,0.333333333333333,0,0,0,0,0.238095238095238,0.333333333333333,0,0,0
"555",0,0,0,0,1,2,3,0,0,0,0,0,0,0,3,0,0.333333333333333,0.666666666666667,0,0,0,0,0,0,0,0,0
"556",0,0,0,0,0,3,3,0,0,0,0,1,4,5,8,0,0,0.375,0,0,0,0,0.125,0.5,0,0,0
"557",0,3,0,0,0,0,3,0,4,1,0,0,0,5,8,0,0,0,0,0,0.375,0,0,0,0,0.125,0.5
"558",0,4,0,0,0,0,4,0,5,4,0,0,0,9,13,0,0,0,0,0,0.307692307692308,0,0,0,0,0.307692307692308,0.384615384615385
"559",0,7,4,4,0,0,15,0,6,2,0,0,0,8,23,0,0,0,0.173913043478261,0.173913043478261,0.304347826086957,0,0,0,0,0.0869565217391304,0.260869565217391
"560",0,29,9,17,0,0,55,0,4,4,0,0,0,8,63,0,0,0,0.26984126984127,0.142857142857143,0.46031746031746,0,0,0,0,0.0634920634920635,0.0634920634920635
"561",17,5,3,4,20,30,79,7,1,3,0,2,0,13,92,0.184782608695652,0.217391304347826,0.326086956521739,0.0434782608695652,0.0326086956521739,0.0543478260869565,0.0760869565217391,0.0217391304347826,0,0,0.0326086956521739,0.0108695652173913
"562",14,0,0,0,13,27,54,19,0,0,0,19,2,40,94,0.148936170212766,0.138297872340426,0.287234042553192,0,0,0,0.202127659574468,0.202127659574468,0.0212765957446809,0,0,0
"563",8,0,0,0,5,20,33,22,0,0,0,19,10,51,84,0.0952380952380952,0.0595238095238095,0.238095238095238,0,0,0,0.261904761904762,0.226190476190476,0.119047619047619,0,0,0
"564",14,0,0,0,11,26,51,22,0,0,0,20,4,46,97,0.144329896907216,0.11340206185567,0.268041237113402,0,0,0,0.22680412371134,0.206185567010309,0.0412371134020619,0,0,0
"565",14,0,0,0,9,23,46,23,0,0,0,19,0,42,88,0.159090909090909,0.102272727272727,0.261363636363636,0,0,0,0.261363636363636,0.215909090909091,0,0,0,0
"566",11,0,0,0,9,32,52,19,0,0,0,21,0,40,92,0.119565217391304,0.0978260869565217,0.347826086956522,0,0,0,0.206521739130435,0.228260869565217,0,0,0,0
"567",11,0,0,0,8,23,42,23,0,0,0,23,0,46,88,0.125,0.0909090909090909,0.261363636363636,0,0,0,0.261363636363636,0.261363636363636,0,0,0,0
"568",6,0,0,0,6,25,37,27,0,0,0,27,0,54,91,0.0659340659340659,0.0659340659340659,0.274725274725275,0,0,0,0.296703296703297,0.296703296703297,0,0,0,0
"569",6,0,0,0,8,32,46,24,0,0,0,25,0,49,95,0.0631578947368421,0.0842105263157895,0.336842105263158,0,0,0,0.252631578947368,0.263157894736842,0,0,0,0
"570",10,0,0,0,9,28,47,25,0,0,0,19,1,45,92,0.108695652173913,0.0978260869565217,0.304347826086957,0,0,0,0.271739130434783,0.206521739130435,0.0108695652173913,0,0,0
"571",15,0,0,0,11,25,51,18,0,0,0,19,6,43,94,0.159574468085106,0.117021276595745,0.265957446808511,0,0,0,0.191489361702128,0.202127659574468,0.0638297872340425,0,0,0
"572",7,0,0,0,6,26,39,24,0,0,0,25,3,52,91,0.0769230769230769,0.0659340659340659,0.285714285714286,0,0,0,0.263736263736264,0.274725274725275,0.032967032967033,0,0,0
"573",12,0,0,0,15,22,49,15,0,0,0,16,6,37,86,0.13953488372093,0.174418604651163,0.255813953488372,0,0,0,0.174418604651163,0.186046511627907,0.0697674418604651,0,0,0
"574",1,0,0,0,13,22,36,20,0,0,0,14,6,40,76,0.0131578947368421,0.171052631578947,0.289473684210526,0,0,0,0.263157894736842,0.184210526315789,0.0789473684210526,0,0,0
"575",3,0,0,0,3,8,14,24,0,0,0,21,7,52,66,0.0454545454545455,0.0454545454545455,0.121212121212121,0,0,0,0.363636363636364,0.318181818181818,0.106060606060606,0,0,0
"576",4,0,0,0,0,2,6,9,0,0,0,20,12,41,47,0.0851063829787234,0,0.0425531914893617,0,0,0,0.191489361702128,0.425531914893617,0.25531914893617,0,0,0
"577",4,0,0,0,0,3,7,0,0,0,0,19,20,39,46,0.0869565217391304,0,0.0652173913043478,0,0,0,0,0.41304347826087,0.434782608695652,0,0,0
"578",0,0,0,0,0,9,9,0,0,0,0,0,9,9,18,0,0,0.5,0,0,0,0,0,0.5,0,0,0
"579",0,0,0,0,0,6,6,0,0,0,0,0,3,3,9,0,0,0.666666666666667,0,0,0,0,0,0.333333333333333,0,0,0
"580",0,0,0,0,0,5,5,0,0,0,0,1,2,3,8,0,0,0.625,0,0,0,0,0.125,0.25,0,0,0
"581",0,1,1,0,0,0,2,0,4,5,0,0,0,9,11,0,0,0,0,0.0909090909090909,0.0909090909090909,0,0,0,0,0.454545454545455,0.363636363636364
"582",0,4,1,0,0,0,5,0,4,5,0,0,0,9,14,0,0,0,0,0.0714285714285714,0.285714285714286,0,0,0,0,0.357142857142857,0.285714285714286
"583",0,11,4,5,0,0,20,0,3,3,0,0,0,6,26,0,0,0,0.192307692307692,0.153846153846154,0.423076923076923,0,0,0,0,0.115384615384615,0.115384615384615
"584",7,14,9,7,5,10,52,0,7,2,0,1,0,10,62,0.112903225806452,0.0806451612903226,0.161290322580645,0.112903225806452,0.145161290322581,0.225806451612903,0,0.0161290322580645,0,0,0.032258064516129,0.112903225806452
"585",16,0,0,0,28,32,76,7,0,0,0,5,0,12,88,0.181818181818182,0.318181818181818,0.363636363636364,0,0,0,0.0795454545454545,0.0568181818181818,0,0,0,0
"586",18,0,0,0,10,28,56,17,0,0,0,17,1,35,91,0.197802197802198,0.10989010989011,0.307692307692308,0,0,0,0.186813186813187,0.186813186813187,0.010989010989011,0,0,0
"587",2,0,0,0,4,23,29,23,0,0,0,25,0,48,77,0.025974025974026,0.051948051948052,0.298701298701299,0,0,0,0.298701298701299,0.324675324675325,0,0,0,0
"588",10,0,0,0,9,21,40,19,0,0,0,19,2,40,80,0.125,0.1125,0.2625,0,0,0,0.2375,0.2375,0.025,0,0,0
"589",12,0,0,0,8,21,41,22,0,0,0,20,1,43,84,0.142857142857143,0.0952380952380952,0.25,0,0,0,0.261904761904762,0.238095238095238,0.0119047619047619,0,0,0
"590",9,0,0,0,10,29,48,23,0,0,0,21,0,44,92,0.0978260869565217,0.108695652173913,0.315217391304348,0,0,0,0.25,0.228260869565217,0,0,0,0
"591",9,0,0,0,7,32,48,22,0,0,0,18,2,42,90,0.1,0.0777777777777778,0.355555555555556,0,0,0,0.244444444444444,0.2,0.0222222222222222,0,0,0
"592",6,0,0,0,10,29,45,25,0,0,0,25,0,50,95,0.0631578947368421,0.105263157894737,0.305263157894737,0,0,0,0.263157894736842,0.263157894736842,0,0,0,0
"593",7,0,0,0,7,29,43,23,0,0,0,25,3,51,94,0.074468085106383,0.074468085106383,0.308510638297872,0,0,0,0.24468085106383,0.265957446808511,0.0319148936170213,0,0,0
"594",9,0,0,0,2,32,43,22,0,0,0,21,2,45,88,0.102272727272727,0.0227272727272727,0.363636363636364,0,0,0,0.25,0.238636363636364,0.0227272727272727,0,0,0
"595",6,0,0,0,7,34,47,26,0,0,0,22,1,49,96,0.0625,0.0729166666666667,0.354166666666667,0,0,0,0.270833333333333,0.229166666666667,0.0104166666666667,0,0,0
"596",3,0,0,0,4,31,38,24,0,0,0,27,0,51,89,0.0337078651685393,0.0449438202247191,0.348314606741573,0,0,0,0.269662921348315,0.303370786516854,0,0,0,0
"597",9,0,0,0,9,28,46,23,0,0,0,22,0,45,91,0.0989010989010989,0.0989010989010989,0.307692307692308,0,0,0,0.252747252747253,0.241758241758242,0,0,0,0
"598",2,0,0,0,9,27,38,22,0,0,0,17,1,40,78,0.0256410256410256,0.115384615384615,0.346153846153846,0,0,0,0.282051282051282,0.217948717948718,0.0128205128205128,0,0,0
"599",2,0,0,0,7,12,21,24,0,0,0,24,3,51,72,0.0277777777777778,0.0972222222222222,0.166666666666667,0,0,0,0.333333333333333,0.333333333333333,0.0416666666666667,0,0,0
"600",5,0,0,0,0,5,10,8,0,0,0,21,13,42,52,0.0961538461538462,0,0.0961538461538462,0,0,0,0.153846153846154,0.403846153846154,0.25,0,0,0
"601",5,0,0,0,4,3,12,0,0,0,0,22,22,44,56,0.0892857142857143,0.0714285714285714,0.0535714285714286,0,0,0,0,0.392857142857143,0.392857142857143,0,0,0
"602",0,0,0,0,3,6,9,0,0,0,0,6,8,14,23,0,0.130434782608696,0.260869565217391,0,0,0,0,0.260869565217391,0.347826086956522,0,0,0
"603",0,0,0,0,3,4,7,0,0,0,0,3,3,6,13,0,0.230769230769231,0.307692307692308,0,0,0,0,0.230769230769231,0.230769230769231,0,0,0
"604",0,0,0,0,0,0,0,0,0,0,0,3,3,6,6,0,0,0,0,0,0,0,0.5,0.5,0,0,0
"605",0,0,0,0,2,3,5,0,0,0,0,2,3,5,10,0,0.2,0.3,0,0,0,0,0.2,0.3,0,0,0
"606",0,0,0,0,1,2,3,0,0,0,0,0,8,8,11,0,0.0909090909090909,0.181818181818182,0,0,0,0,0,0.727272727272727,0,0,0
"607",0,8,0,4,0,0,12,0,2,4,0,0,0,6,18,0,0,0,0.222222222222222,0,0.444444444444444,0,0,0,0,0.222222222222222,0.111111111111111
"608",16,2,0,0,13,31,62,3,0,1,0,2,0,6,68,0.235294117647059,0.191176470588235,0.455882352941176,0,0,0.0294117647058824,0.0441176470588235,0.0294117647058824,0,0,0.0147058823529412,0
"609",15,0,0,0,20,33,68,7,0,0,0,4,0,11,79,0.189873417721519,0.253164556962025,0.417721518987342,0,0,0,0.0886075949367089,0.0506329113924051,0,0,0,0
"610",16,0,0,0,12,27,55,19,0,0,0,16,0,35,90,0.177777777777778,0.133333333333333,0.3,0,0,0,0.211111111111111,0.177777777777778,0,0,0,0
"611",6,0,0,0,8,30,44,23,0,0,0,24,2,49,93,0.0645161290322581,0.0860215053763441,0.32258064516129,0,0,0,0.247311827956989,0.258064516129032,0.021505376344086,0,0,0
"612",7,0,0,0,9,27,43,23,0,0,0,22,2,47,90,0.0777777777777778,0.1,0.3,0,0,0,0.255555555555556,0.244444444444444,0.0222222222222222,0,0,0
"613",9,0,0,0,11,29,49,18,0,0,0,19,1,38,87,0.103448275862069,0.126436781609195,0.333333333333333,0,0,0,0.206896551724138,0.218390804597701,0.0114942528735632,0,0,0
"614",5,0,0,0,13,27,45,21,0,0,0,18,2,41,86,0.0581395348837209,0.151162790697674,0.313953488372093,0,0,0,0.244186046511628,0.209302325581395,0.0232558139534884,0,0,0
"615",8,0,0,0,5,26,39,20,0,0,0,18,3,41,80,0.1,0.0625,0.325,0,0,0,0.25,0.225,0.0375,0,0,0
"616",9,0,0,0,13,27,49,23,0,0,0,20,6,49,98,0.0918367346938776,0.13265306122449,0.275510204081633,0,0,0,0.23469387755102,0.204081632653061,0.0612244897959184,0,0,0
"617",5,0,0,0,3,25,33,24,0,0,0,24,3,51,84,0.0595238095238095,0.0357142857142857,0.297619047619048,0,0,0,0.285714285714286,0.285714285714286,0.0357142857142857,0,0,0
"618",7,0,0,0,10,23,40,23,0,0,0,21,5,49,89,0.0786516853932584,0.112359550561798,0.258426966292135,0,0,0,0.258426966292135,0.235955056179775,0.0561797752808989,0,0,0
"619",12,0,0,0,12,35,59,19,0,0,0,18,0,37,96,0.125,0.125,0.364583333333333,0,0,0,0.197916666666667,0.1875,0,0,0,0
"620",8,0,0,0,5,23,36,23,0,0,0,22,2,47,83,0.0963855421686747,0.0602409638554217,0.27710843373494,0,0,0,0.27710843373494,0.265060240963855,0.0240963855421687,0,0,0
"621",8,0,0,0,15,30,53,22,0,0,0,21,1,44,97,0.0824742268041237,0.154639175257732,0.309278350515464,0,0,0,0.22680412371134,0.216494845360825,0.0103092783505155,0,0,0
"622",6,0,0,0,7,22,35,20,0,0,0,18,1,39,74,0.0810810810810811,0.0945945945945946,0.297297297297297,0,0,0,0.27027027027027,0.243243243243243,0.0135135135135135,0,0,0
"623",1,0,0,0,5,14,20,21,0,0,0,23,2,46,66,0.0151515151515152,0.0757575757575758,0.212121212121212,0,0,0,0.318181818181818,0.348484848484849,0.0303030303030303,0,0,0
"624",3,0,0,0,0,2,5,13,0,0,0,19,7,39,44,0.0681818181818182,0,0.0454545454545455,0,0,0,0.295454545454545,0.431818181818182,0.159090909090909,0,0,0
"625",11,0,0,0,0,1,12,0,0,0,0,23,23,46,58,0.189655172413793,0,0.0172413793103448,0,0,0,0,0.396551724137931,0.396551724137931,0,0,0
"626",0,0,0,0,2,3,5,0,0,0,0,12,7,19,24,0,0.0833333333333333,0.125,0,0,0,0,0.5,0.291666666666667,0,0,0
"627",0,0,0,0,0,7,7,0,0,0,0,5,0,5,12,0,0,0.583333333333333,0,0,0,0,0.416666666666667,0,0,0,0
"628",0,0,0,0,0,4,4,0,0,0,0,3,0,3,7,0,0,0.571428571428571,0,0,0,0,0.428571428571429,0,0,0,0
"629",0,0,0,0,0,1,1,0,0,0,0,7,0,7,8,0,0,0.125,0,0,0,0,0.875,0,0,0,0
"630",0,0,0,0,1,7,8,0,0,0,0,3,1,4,12,0,0.0833333333333333,0.583333333333333,0,0,0,0,0.25,0.0833333333333333,0,0,0
"631",4,0,0,0,5,6,15,1,0,0,0,11,0,12,27,0.148148148148148,0.185185185185185,0.222222222222222,0,0,0,0.037037037037037,0.407407407407407,0,0,0,0
"632",17,0,0,0,21,29,67,3,0,0,0,3,1,7,74,0.22972972972973,0.283783783783784,0.391891891891892,0,0,0,0.0405405405405405,0.0405405405405405,0.0135135135135135,0,0,0
"633",15,0,0,0,27,28,70,8,0,0,0,4,0,12,82,0.182926829268293,0.329268292682927,0.341463414634146,0,0,0,0.0975609756097561,0.0487804878048781,0,0,0,0
"634",11,0,0,0,12,26,49,14,0,0,0,12,4,30,79,0.139240506329114,0.151898734177215,0.329113924050633,0,0,0,0.177215189873418,0.151898734177215,0.0506329113924051,0,0,0
"635",8,0,0,0,5,14,27,22,0,0,0,17,11,50,77,0.103896103896104,0.0649350649350649,0.181818181818182,0,0,0,0.285714285714286,0.220779220779221,0.142857142857143,0,0,0
"636",13,0,0,0,8,18,39,23,0,0,0,18,12,53,92,0.141304347826087,0.0869565217391304,0.195652173913043,0,0,0,0.25,0.195652173913043,0.130434782608696,0,0,0
"637",10,0,0,0,8,25,43,23,0,0,0,20,5,48,91,0.10989010989011,0.0879120879120879,0.274725274725275,0,0,0,0.252747252747253,0.21978021978022,0.0549450549450549,0,0,0
"638",14,0,0,0,15,25,54,19,0,0,0,18,6,43,97,0.144329896907216,0.154639175257732,0.257731958762887,0,0,0,0.195876288659794,0.185567010309278,0.0618556701030928,0,0,0
"639",17,0,0,0,9,24,50,18,0,0,0,18,8,44,94,0.180851063829787,0.0957446808510638,0.25531914893617,0,0,0,0.191489361702128,0.191489361702128,0.0851063829787234,0,0,0
"640",11,0,0,0,14,21,46,21,0,0,0,17,8,46,92,0.119565217391304,0.152173913043478,0.228260869565217,0,0,0,0.228260869565217,0.184782608695652,0.0869565217391304,0,0,0
"641",14,0,0,0,4,16,34,21,0,0,0,17,15,53,87,0.160919540229885,0.0459770114942529,0.183908045977011,0,0,0,0.241379310344828,0.195402298850575,0.172413793103448,0,0,0
"642",14,0,0,0,9,25,48,19,0,0,0,19,8,46,94,0.148936170212766,0.0957446808510638,0.265957446808511,0,0,0,0.202127659574468,0.202127659574468,0.0851063829787234,0,0,0
"643",9,0,0,0,8,26,43,24,0,0,0,14,6,44,87,0.103448275862069,0.0919540229885057,0.298850574712644,0,0,0,0.275862068965517,0.160919540229885,0.0689655172413793,0,0,0
"644",15,0,0,0,11,17,43,20,0,0,0,21,14,55,98,0.153061224489796,0.112244897959184,0.173469387755102,0,0,0,0.204081632653061,0.214285714285714,0.142857142857143,0,0,0
"645",12,0,0,0,14,24,50,18,0,0,0,18,9,45,95,0.126315789473684,0.147368421052632,0.252631578947368,0,0,0,0.189473684210526,0.189473684210526,0.0947368421052632,0,0,0
"646",7,0,0,0,14,26,47,20,0,0,0,13,6,39,86,0.0813953488372093,0.162790697674419,0.302325581395349,0,0,0,0.232558139534884,0.151162790697674,0.0697674418604651,0,0,0
"647",6,0,0,0,7,13,26,19,0,0,0,19,16,54,80,0.075,0.0875,0.1625,0,0,0,0.2375,0.2375,0.2,0,0,0
"648",9,0,0,0,1,1,11,9,0,0,0,17,18,44,55,0.163636363636364,0.0181818181818182,0.0181818181818182,0,0,0,0.163636363636364,0.309090909090909,0.327272727272727,0,0,0
"649",10,0,0,0,2,0,12,0,0,0,0,24,22,46,58,0.172413793103448,0.0344827586206897,0,0,0,0,0,0.413793103448276,0.379310344827586,0,0,0
"650",0,0,0,0,4,8,12,0,0,0,0,6,7,13,25,0,0.16,0.32,0,0,0,0,0.24,0.28,0,0,0
"651",0,0,0,0,2,4,6,0,0,0,0,4,2,6,12,0,0.166666666666667,0.333333333333333,0,0,0,0,0.333333333333333,0.166666666666667,0,0,0
"652",0,0,0,0,1,2,3,0,0,0,0,0,4,4,7,0,0.142857142857143,0.285714285714286,0,0,0,0,0,0.571428571428571,0,0,0
"653",0,0,0,0,1,3,4,1,0,0,0,2,5,8,12,0,0.0833333333333333,0.25,0,0,0,0.0833333333333333,0.166666666666667,0.416666666666667,0,0,0
"654",0,0,0,0,0,3,3,0,0,0,0,1,7,8,11,0,0,0.272727272727273,0,0,0,0,0.0909090909090909,0.636363636363636,0,0,0
"655",4,0,0,0,6,7,17,0,0,0,0,0,8,8,25,0.16,0.24,0.28,0,0,0,0,0,0.32,0,0,0
"656",16,0,0,0,14,29,59,0,0,0,0,3,1,4,63,0.253968253968254,0.222222222222222,0.46031746031746,0,0,0,0,0.0476190476190476,0.0158730158730159,0,0,0
"657",19,0,0,0,21,36,76,1,0,0,0,13,0,14,90,0.211111111111111,0.233333333333333,0.4,0,0,0,0.0111111111111111,0.144444444444444,0,0,0,0
"658",16,0,0,0,15,24,55,14,0,0,0,15,5,34,89,0.179775280898876,0.168539325842697,0.269662921348315,0,0,0,0.157303370786517,0.168539325842697,0.0561797752808989,0,0,0
"659",4,0,0,0,6,22,32,20,0,0,0,18,12,50,82,0.0487804878048781,0.0731707317073171,0.268292682926829,0,0,0,0.24390243902439,0.219512195121951,0.146341463414634,0,0,0
"660",11,0,0,0,8,27,46,20,0,0,0,14,9,43,89,0.123595505617978,0.0898876404494382,0.303370786516854,0,0,0,0.224719101123595,0.157303370786517,0.101123595505618,0,0,0
"661",12,0,0,0,9,25,46,20,0,0,0,17,7,44,90,0.133333333333333,0.1,0.277777777777778,0,0,0,0.222222222222222,0.188888888888889,0.0777777777777778,0,0,0
"662",14,0,0,0,12,25,51,19,0,0,0,18,4,41,92,0.152173913043478,0.130434782608696,0.271739130434783,0,0,0,0.206521739130435,0.195652173913043,0.0434782608695652,0,0,0
"663",13,0,0,0,6,29,48,21,0,0,0,22,3,46,94,0.138297872340426,0.0638297872340425,0.308510638297872,0,0,0,0.223404255319149,0.234042553191489,0.0319148936170213,0,0,0
"664",8,0,0,0,12,21,41,18,0,0,0,18,8,44,85,0.0941176470588235,0.141176470588235,0.247058823529412,0,0,0,0.211764705882353,0.211764705882353,0.0941176470588235,0,0,0
"665",8,0,0,0,6,25,39,25,0,0,0,24,4,53,92,0.0869565217391304,0.0652173913043478,0.271739130434783,0,0,0,0.271739130434783,0.260869565217391,0.0434782608695652,0,0,0
"666",10,0,0,0,14,27,51,25,0,0,0,15,5,45,96,0.104166666666667,0.145833333333333,0.28125,0,0,0,0.260416666666667,0.15625,0.0520833333333333,0,0,0
"667",7,0,0,0,7,26,40,24,0,0,0,20,6,50,90,0.0777777777777778,0.0777777777777778,0.288888888888889,0,0,0,0.266666666666667,0.222222222222222,0.0666666666666667,0,0,0
"668",10,0,0,0,9,27,46,19,0,0,0,20,3,42,88,0.113636363636364,0.102272727272727,0.306818181818182,0,0,0,0.215909090909091,0.227272727272727,0.0340909090909091,0,0,0
"669",9,0,0,0,9,24,42,23,0,0,0,21,8,52,94,0.0957446808510638,0.0957446808510638,0.25531914893617,0,0,0,0.24468085106383,0.223404255319149,0.0851063829787234,0,0,0
"670",9,0,0,0,16,23,48,19,0,0,0,14,7,40,88,0.102272727272727,0.181818181818182,0.261363636363636,0,0,0,0.215909090909091,0.159090909090909,0.0795454545454545,0,0,0
"671",5,0,0,0,7,17,29,21,0,0,0,21,12,54,83,0.0602409638554217,0.0843373493975904,0.204819277108434,0,0,0,0.253012048192771,0.253012048192771,0.144578313253012,0,0,0
"672",5,0,0,0,0,4,9,14,0,0,0,20,18,52,61,0.0819672131147541,0,0.0655737704918033,0,0,0,0.229508196721311,0.327868852459016,0.295081967213115,0,0,0
